The young boys are playing outdoors and the man is smiling nearby	The kids are playing outdoors near a man with a smile	1
A man with a jersey is dunking the ball at a basketball game	The ball is being dunked by a man with a jersey at a basketball game	1
Two people are kickboxing and spectators are not watching	Two people are kickboxing and spectators are watching	0
Two young women are sparring in a kickboxing fight	Two women are sparring in a kickboxing match	1
Three boys are jumping in the leaves	Three kids are jumping in the leaves	1
People wearing costumes are gathering in a forest and are looking in the same direction	Masked people are looking in the same direction in a forest	1
A lone biker is jumping in the air	A biker is jumping in the air, alone	1
There is no biker jumping in the air	A lone biker is jumping in the air	0
A man is jumping into an empty pool	A man is jumping into a full pool	0
Four kids are doing backbends in the park	Four children are doing backbends in the park	1
Four girls are doing backbends and playing in the garden	Four girls are doing backbends and playing outdoors	1
A man who is playing is running with the ball in his hands	A player is running with the ball	1
Five kids are standing close together and one kid has a gun	Five kids are standing close together and none of the kids has a gun	0
An old man is sitting in a field	A man is sitting in a field	1
The current is being ridden by a group of friends in a raft	A group of friends are riding the current in a raft	1
A group of friends are riding the current in a raft	A group is not riding the current in a raft	0
A deer is jumping over a fence	A deer isn't jumping over the fence	0
Several people are in front of a colorful building	Nobody is in front of the colorful building	0
People are walking outside the building that has several murals on it	Several people are in front of a colorful building	1
A motorcycle rider is standing up on the seat of a white motorcycle	No motorcycle rider is standing up on the seat of a motorcycle	0
Nobody is on a motorcycle and is standing on the seat	Someone is on a black and white motorcycle and is standing on the seat	0
A motorcyclist is riding a motorbike dangerously along a roadway	A motorcyclist is riding a motorbike along a roadway	1
There is no motorcyclist riding a motorbike along a roadway	A motorcyclist is riding a motorbike along a roadway	0
A man with a helmet painted red is riding a blue motorcycle down the road	A motorcyclist with a red helmet is riding a blue motorcycle down the road	1
Three Asian kids are dancing and a man is looking	Three Asian kids are dancing and there is no man looking	0
A woman is wearing an Egyptian hat on her head	A woman is wearing an Egyptian headdress	1
A hiker is on top of the mountain and is dancing	There is no hiker dancing on top of the mountain	0
There is no man on a rock high above some trees standing in a strange position	A man is on a rock high above some trees and is standing in a strange position	0
The brown horse is very near a red barrel at the rodeo	The brown horse is near a red barrel at the rodeo	1
The brown horse is near a red barrel at the rodeo	The brown horse is far from a red barrel at the rodeo	0
A boy is standing in the cold water	A boy is standing in the water	1
The boy is sitting near the blue ocean	The boy is wading through the blue ocean	0
A man is playing a guitar on stage	There is no man playing a guitar on stage	0
Two young girls are sitting on the ground	Two girls are sitting on the ground	1
A nude lady is walking in front of a crowd in body paint	There is no lady walking in body paint in front of a crowd 	0
A young, topless woman is covered in paint	A topless girl is covered in paint	1
A nude lady is walking in front of a crowd in body paint	A topless girl is covered in paint	1
A group of people is near the ocean	A crowd of people is near the water	1
A crowd of people is near the water	A crowd of people is far from the water	0
A group of children in uniforms is standing at a gate and one is kissing the mother	A group of children wearing the same clothes is waiting at a gate and one is kissing the mother	1
A group of people is on a beach	A group of people is near the sea	1
A man, a woman and two girls are walking on the beach	Four people are walking on the beach	1
A man, a woman and two girls are walking on the beach	A group of people is on a beach	1
A schoolgirl with a black bag is on a crowded train	A girl with a black bag is on a crowded train	1
There is no girl with a black bag on a crowded train	A girl with a black bag is on a crowded train	0
A dog is chasing another and is holding a stick in its mouth	A dog is chasing another and is holding a piece of wood in its mouth	1
Two dogs are running and carrying a toy in their mouths	Two dogs are running and carrying an object in their mouths	1
A dog is chasing another and is holding a stick in its mouth	Two dogs are running and carrying an object in their mouths	1
A dirty soccer ball is rolling into a goal net	A soccer ball is rolling into a goal net	1
A soccer ball is not rolling into a goal net	A soccer ball is rolling into a goal net	0
A man is sitting on a chair and rubbing his eyes	There is no man sitting on a chair and rubbing his eyes	0
A man with tattoos is lounging on a couch and holding a pencil	A tattooed man is on a sofa and is holding a pencil	1
A white and tan dog is running through the tall and green grass	A brown and white dog is running through the tall grass	1
A man with paint covered clothes is sitting outside in a busy area writing something	A man is wearing clothes that are covered with paint and is sitting outside in a busy area writing something	1
There is no man wearing clothes that are covered with paint or is sitting outside in a busy area writing something	A man is wearing clothes that are covered with paint and is sitting outside in a busy area writing something	0
A man is sitting near a bike and is writing a note	There is no man writing a note near a bike	0
Some people are walking	People are walking	1
A group of scouts are hiking through the grass	Some people are walking	1
Two men are holding fishing poles and fishing tackle	Two men are holding fishing poles	1
Two men are not holding fishing poles	Two men are holding fishing poles	0
A blonds girl is surfing	A blond girl is riding the waves	1
Two children and an adult are standing next to a tree limb	Two children and an adult are not standing next to a tree limb	0
A man is performing stunts on a green bicycle	A man is performing a trick on a green bicycle	1
A boy is holding a squirt gun	A child is holding a squirt gun	1
There is no child holding a water gun or getting sprayed with water	A laughing child is holding a water gun and getting sprayed with water	0
A child with a gun that sprays water is laughing and getting hit by other boys	A child is holding a squirt gun	1
There is no dog playing with a red ball	Two daschunds are playing with a red ball	0
The black and white dog is running and a person stands behind it	The dog, which is black and white, is running and a person stands behind it	1
A little dog is sprinting and the person who owns it is trying to catch it	A little dog is sprinting and its owner is trying to catch it	1
A man wearing a dyed black shirt is sitting at the table and laughing	A black shirt is being worn by a man who is sitting at the table and laughing	1
A man wearing a dyed black shirt is sitting at the table and laughing	There is no man wearing a shirt dyed black, sitting at the table and laughing	0
A woman who is wearing a pink boa is riding a bicycle down a bridge built for pedestrians	A woman who is wearing a pink scarf is riding a bike down a bridge built for pedestrians	1
A person, who is riding a bike, is wearing gear which is black	A biker is wearing gear which is black	1
A biker is naked	A biker is wearing gear which is black	0
A black helmet is being worn by a man who is pushing a bicycle	One man is wearing a black helmet and pushing a bicycle	1
The man in a grey t-shirt is sitting on a rock in front of the waterfall	The man in a t-shirt dyed grey is sitting on a rock in front of a waterfall	1
The man in a grey t-shirt is sitting on a rock in front of the waterfall	There is no man in a grey t-shirt sitting on a rock in front of the waterfall	0
A dog, which is brown, and a black one are running in the grass	There is no dog running in the grass	0
A dark black dog and a light brown dog are playing in the yard in the back	A dark black dog and a light brown dog are playing in the backyard	1
A white and brown dog is walking through the water with difficulty	A white and brown dog is pacing through the water with difficulty	1
A bunch of boys are playing with a ball in front of a large door made of wood	The children are playing in front of a large door	1
A young lady with light brown hair is wearing a red necklace, a sweatshirt and earrings and is smiling	A lady of young age, with light brown hair, is wearing a red necklace, a sweatshirt and earrings and is smiling	1
A young lady with light brown hair is wearing a red necklace, a sweatshirt and earrings and is smiling	There is no young lady with light brown hair wearing a red necklace, a sweatshirt and earrings and smiling	0
A dad is launching his daughter into a swimming pool	A father is launching the daughter in a swimming pool	1
The man is tossing a kid into the swimming pool that is near the ocean	One man is tossing a kid into the swimming pool that is near the ocean	1
A rock is being climbed by a person with a rope, which is pink	One man is climbing a cliff with a rope	1
A person is climbing a rock with a rope, which is pink	One man is climbing the cliff with a rope	1
A young boy isn't climbing a wall made of rock	The young boy is climbing the wall made of rock	0
A young child is climbing a rock climbing wall which is indoors	A young kid is climbing a rock climbing wall which is indoors	1
The cyclist is performing a trick in the air	The cyclist isn't performing a trick in the air	0
A dog, which is black, and a white one are staring at each other in the street	A dog, which is black, and another one, which is white, are staring at each other in the street	1
Two dogs of different breeds are looking angrily at each other across a street	Two dogs of different breeds are looking at each other across a street	1
Two dogs of different breeds are looking at each other across a street	There are no dogs of different breeds looking at each other across a street	0
A dog which is furry and black is in a backyard and is carrying a basket in its mouth.	A dog which is furry and black is in a back yard and is carrying a basket in its mouth	1
A dog which is furry and black is in a back yard and is carrying a basket in its mouth	There is no dog which is furry and black in a back yard carrying a basket in its mouth.	0
Two persons of large size are sitting on a park bench and they have a bottle of soda between them	Two large persons are sitting on a park bench and they have a bottle of soda between them	1
Two large persons are sitting on a park bench and they have a bottle of soda between them	Two large persons are standing near a park bench and they have nothing between them	0
Two large park benches have a person sitting and a bottle of soda between them	Two large persons are sitting on a park bench and they have a bottle of soda between them	1
A man with a camera is studying the subject	There is no man with a camera studying the subject	0
The man with the dyed purple hat is operating a camera that makes videos	The man in the purple hat is operating a camera that makes videos	1
The man in the purple hat isn't operating a camera that makes videos	The man in the purple hat is operating a camera that makes videos	0
The bride and the groom are leaving after the marriage	The bride and the groom are leaving after the wedding	1
A married couple is walking up the aisle	A married couple is walking down the aisle	1
The presentation is being watched by a classroom of students	The presentation is being attended by a classroom of students	1
The kid is happily sliding in the snow	The kid is sliding in the snow	1
A boy on a hill covered in snow is wearing a red jacket and a black hat and is sliding on his knees	The kid is still in the snow	1
A woman and a dog are peacefully sitting on a tree stump	A woman and a dog are sitting on a tree stump	1
A woman, who is old, is near a dog that has a white coat	A woman, who is old, is near a white dog	1
The dog is biting some droplets of water	The dog is snapping at some droplets of water	1
The dog is snapping at some droplets of water	The dog isn't snapping at some droplets of water	0
Two people are in the snow, wearing clothes that provide camouflage	Some people are in the snow, wearing clothes that provide camouflage	1
Nobody is in the snow wearing clothes that provide camouflage	Two people are in the snow, wearing clothes that provide camouflage	0
The little kid is playing football and falling harmlessly into the grass	The little kid is playing football and falling into the grass	1
There is no little kid playing football and falling into the grass	The little kid is playing football and falling into the grass	0
A woman with a ponytail is climbing down a wall of rock	A woman with a ponytail is climbing a wall of rock	1
One white dog and one black one are cheerfully running side by side on the grass	A black and a white dog are joyfully running on the grass	1
A lot of people are in an ice skating park	Not a lot of people are in an ice skating park	0
The ice skating rink placed outdoors is full of people	An ice skating rink placed outdoors is full of people	1
An ice skating rink placed outdoors is empty	An ice skating rink placed outdoors is full of people	0
The ice skating rink placed outdoors is full of people	A lot of people are in an ice skating park	1
An ice skating rink placed outdoors is full of people	There aren't many people in the ice skating park	0
An ice skating rink placed outdoors is full of people	A lot of people are in an ice skating park	1
The girl in the blue and white uniform is cheering	Some cheers are being performed by the girl in the blue and white uniform	1
The girl in the blue and white uniform isn't cheering	The girl in the blue and white uniform is cheering	0
People are on a beach full of sand by the ocean and are enjoying a sunny day	People are on a beach full of sand by the ocean and are enjoying a day full of sun	1
People are on a beach full of sand by the ocean and are enjoying a sunny day	A bunch of people is on the shore	1
The man is doing a wheelie with a motorbike in a field which is mostly barren	The man is doing a wheelie with a motorcycle on ground which is mostly barren	1
The young girl is blowing a bubble that is huge	The young girl is blowing a bubble that is very small	0
Two young kids are eating corndogs	Two young children are eating corndogs	1
Two toddlers are eating corndogs in a wagon, which is really small	Two young children are eating corndogs	1
Some corndogs are being eaten by two toddlers who are in a wagon, which is really small	Two young kids are eating corndogs	1
Two toddlers are eating corndogs in a wagon, which is really small	Two young kids are eating corndogs	1
A man in a shirt dyed purple is looking at a man in a black shirt who is doing a funny face	A man in a shirt dyed purple is looking at a man in a black shirt who is doing a face which looks funny	1
A man in a shirt dyed purple is walking away from a man in a black shirt, who is serious	A man in a shirt dyed purple is looking at a man in a black shirt who is doing a funny face	1
A man in a pose is being amusedly watched by another man	A man doing a pose is being watched by another man	1
A horse is tossing the cowboy wearing pants of blue and red color	The cowboy in blue and red pants is being tossed by a horse	1
The man and the boy are standing at the bottom of the stairs, which are outdoors	A man and a boy are standing at the bottom of some stairs, which are outdoors	1
There is no boy standing in front of the blue building in the space reserved for handicapped people	A boy is standing in front of the blue building in the space reserved for handicapped people	0
The Jockeys are riding horses on the field, which is completely green	The Jockeys are racing horses on the field, which is completely green	1
The green field for horse races is completely full of Jockeys	The Jockeys are racing horses on the field, which is completely green	1
A woman is wearing sunglasses of large size and is holding newspapers in both hands	The woman is wearing sunglasses of large size and is holding newspapers in both hands	1
A woman is wearing sunglasses of large size and is holding newspapers in both hands	There is no woman wearing sunglasses of large size and holding newspapers in both hands	0
The snowboarder is leaping fearlessly over white snow	A person who is practicing snowboarding jumps into the air	1
The snowboarder is leaping over white snow	A person who is practicing snowboarding jumps into the air	1
A dog is near a ball colored in red, which is in the air	A dog is near the red ball in the air	1
A dog is near the red ball in the air	A dog is far from the red ball in the air	0
A dog, which is small, is playing tirelessly on the green grass	A dog, which is small, is playing on the green grass	1
A man is riding a motorbike in the event related to motocross	A person is riding a motorbike in the event related to motocross	1
The young girl with a pink shirt is peacefully lying on the grass	The young girl with a pink shirt isn't peacefully lying on the grass	0
A dog of large size is running on the grass with a tennis ball in its mouth	A large dog is running on the grass with a tennis ball in its mouth	1
There is no large dog running on the grass with a tennis ball in its mouth	A large dog is running on the grass with a tennis ball in its mouth	0
A dog, which is large and gray, is carrying a ball in its mouth and running across the grass	A large dog is running on the grass with a tennis ball in its mouth	1
A man is opening a small package that contains headphones	A man is opening a package that contains headphones	1
There is no woman riding a horse	A woman is riding a horse	0
A man is singing and playing the guitar	A man is singing a song and playing the guitar	1
A dog is riding a skateboard in a park	A dog is riding a skateboard	1
A dog is riding a skateboard	There is no dog riding a skateboard	0
A dog is riding a skateboard	There is no dog riding a skateboard	0
There is no dog riding a skateboard	A dog is riding a skateboard	0
The turtle is following the red fish	The turtle is following the fish	1
There is no man playing a guitar	A man is playing a guitar	0
A woman is adding ingredients to a big bowl	A woman is adding ingredients to a bowl	1
A woman is cracking some eggs into a bowl	A woman is adding ingredients to a bowl	1
There is no woman slicing a carrot	A woman is slicing a carrot	0
There is no woman slicing a potato	A woman is slicing a potato	0
A man and a woman are hiking through a wooded area	A man and a woman are walking through a wooded area	1
A man and a woman are walking together through wooded areas	A man and a woman are walking through a wooded area	1
A man is making a speech on a podium	A man is speaking on a podium	1
A man is speaking on a podium	There is no man speaking on a podium	0
A man is speaking on a podium	A podium is where a man is speaking	1
A woman is talking on a telephonic device	A woman is talking on a telephone	1
A woman is not talking on a telephone	A woman is talking on a telephone	0
A man is slicing a tomato	There is no man slicing a tomato	0
A woman is removing the peel of a potato	A woman is peeling a potato	1
A woman is amalgamating eggs	A woman is mixing eggs	1
A band is performing on a stage	A band is playing onstage	1
There is no man mixing	A man is mixing	0
A man is walking in a yard	A man is walking outside	1
A black cat is swinging on a fan	A cat is swinging on a fan	1
A cat is playing on a moving ceiling fan	A cat is swinging on a fan	1
A cat is stuck on a moving ceiling fan	There is no cat swinging on a fan	0
A man is playing flute	There is no man playing flute	0
A person is performing a card trick	A person is doing a trick with some cards	1
A boy is spanking a man with a plastic sword	A boy is spanking a man with a toy weapon	1
A boy is whacking a man with a sword	A man is being hit by a kid with a weapon	1
The lady is measuring the ankle of another woman	A woman is being measured by another woman	1
There is no man making a phone call	A man is making a phone call	0
A man is talking on a cell phone	A man is making a call on a cell phone	1
There is no dog rolling from side to side	A dog is rolling from side to side	0
There is no puppy rolling	A puppy is repeatedly rolling from side to side on its back	0
A machine is sharpening a pencil	A pencil is being sharpened	1
The machine is not shaving a pencil	The machine is shaving the end of a pencil	0
There is no man playing a keyboard	A man is playing a keyboard	0
A person is not playing the keyboard	A man is playing a keyboard	0
A man is playing a keyboard in a park	A person is playing the keyboard	1
A man is rinsing a large steak	A man is rinsing a large piece of meat	1
A steak is being rinsed with water by a person	A person is rinsing a steak with water	1
Nobody is rinsing a steak with water	A person is rinsing a steak with water	0
Nobody is rinsing a steak with water	A man is rinsing a large steak	0
A person is chopping a red onion	A person is chopping an onion	1
A person is not chopping an onion	A person is chopping an onion	0
A person is riding an old motorcycle	A person is riding a motorcycle	1
A person is riding a motorcycle	A person is standing near a motorcycle	0
Butter is being chopped into a container by a man	A man is chopping butter into a container	1
A man is chopping butter into a small container	A man is chopping butter into a container	1
Some men are sawing	Men are sawing	1
Some men are sawing	There are no men sawing	0
Men are sawing logs	There are no men sawing	0
A man is playing a guitar	A man is not playing a guitar	0
A man is playing a keyboard	A musician is playing a keyboard	1
A man is spreading dough	Dough is being spread by a man	1
Three men are jumping off a tall wall	Three men are jumping off a wall	1
Three men are jumping on a wall	Three men are jumping off a wall	0
A deer is jumping over a cyclone fence	The deer is not jumping over the fence	0
A deer is standing inside a fence	The deer is jumping over the fence	0
A deer is jumping over a cyclone fence	The deer is jumping over the fence	1
The oil is being stirred by a man	The man is stirring oil	1
There is no man playing guitar	A man is playing guitar	0
A man is playing guitar	There is no man playing a guitar	0
A man is playing an electric guitar	A man is playing a guitar	1
A man is playing a guitar	A man is playing guitar	1
Three men are practicing karate in a field	Three men are practicing karate outdoors	1
Some women are holding each other in a circle and dancing	A few women are holding each other and dancing together	1
Two men are playing table tennis	Two men are playing ping pong	1
Two men are playing table football	Two men are playing table tennis	0
There is no woman cutting broccoli	A woman is cutting broccoli	0
A woman is cutting a white onion	A woman is cutting an onion	1
A woman is cutting an onion	There is no woman cutting an onion	0
A man is playing two keyboards	There is no man playing two keyboards	0
Mimes are performing on a small stage	Mimes are performing on a stage	1
The men are acting on a stage	The men are performing on stage	1
A man is picking up a tree	A tree is being picked up by a man	1
A man is passionately playing the guitar	A man is playing the guitar	1
A man is playing the guitar	There is no man playing the guitar	0
A badger, which is shrewd, is digging the earth	A badger is shrewdly digging the earth	1
A badger, which is shrewd, is digging the earth	The badger is burrowing a hole	1
A badger is shrewdly digging the earth	The badger isn't burrowing a hole	0
A badger is shrewdly digging the earth	The badger is burrowing a hole	1
Some liquid is being poured into a pan by a man	A man is pouring liquid into a pot	1
A man is pouring liquid into a pot	There is no man pouring liquid into a pot	0
The man is operating a stenograph	The man isn't operating a stenograph	0
The man is typing on a machine used for stenography	The man is operating a stenograph	1
The man is operating a stenograph	A man is typing on a machine used for stenography	1
A snake is being fed a mouse by a man	One man is feeding a mouse to the snake	1
The man is carefully feeding a mouse to the snake	The man is cautiously feeding a mouse to the snake	1
The man is carefully feeding a mouse to the snake	A snake is being fed a mouse by a man	1
The man is cautiously feeding a mouse to the snake	One man is feeding a mouse to the snake	1
No snake is being fed a mouse by a man	The man is cautiously feeding a mouse to the snake	0
A guy is cheerfully playing with the footbag	A guy is cheerfully playing with a footbag	1
The man isn't playing the piano	The man is playing a piano	0
A man is mixing a few ingredients in a bowl	Some ingredients are being mixed in a bowl by a person	1
A woman is breaking two eggs in a bowl	There is no woman breaking eggs in a bowl	0
The girl is recklessly jumping onto a car	The girl is recklessly jumping onto a vehicle	1
The girl is recklessly jumping onto a car	The girl isn't jumping onto the car recklessly	0
One young lady is jumping on the car	One girl is jumping on the car	1
The girl is recklessly jumping onto a car	One young lady is jumping on the car	1
The girl is recklessly jumping onto a car	One girl is jumping on the car	1
One woman is slowly peeling a potato	One woman is peeling a potato	1
The potato is being peeled by a woman	The potato isn't being peeled by a woman	0
One woman is peeling a potato	The potato isn't being peeled by a woman	0
One woman is slowly peeling a potato	The potato is being peeled by a woman	1
There is no woman peeling a potato	The potato is being peeled by a woman	0
The potato is being peeled by a woman	One woman is peeling a potato	1
The guitar is being played by the man	The guitar is being played by nobody	0
The guitar is being played by the man	The man is a guitar player	1
The man is pouring oil on a few tomatoes	One person pours oil on a few tomatoes	1
Some oil is being poured on the tomatoes by the man	The man is pouring some oil on the tomatoes	1
The man is pouring some oil on the tomatoes	A man isn't pouring oil on the tomatoes.	0
There is no milk being drunk by a cat	The milk is being drunk by a cat	0
A kitten is drinking fresh milk	There is no kitten drinking milk	0
A kitten is drinking fresh milk	There is no milk being drunk by a cat	0
A kitten is drinking fresh milk	The milk is being drunk by a cat	1
A frog is being held carelessly by a man	A man is carelessly holding a frog	1
A man is slicing an onion	An onion is being sliced by a man	1
An onion is being cut by a man	The onion is being cut by the man	1
No onion is being cut by a man	An onion is being cut by a man	0
An onion is being sliced by a man	An onion is being cut by a man	1
A man is recklessly riding a horse	A person is recklessly riding a horse	1
A man is recklessly riding a horse	There is no man recklessly riding a horse	0
Somebody is playing the piano	The piano is being played by someone	1
One man is turning on the microwave	One man is turning off the microwave	0
One man is turning on the microwave	There is no man is pushing the buttons of a microwave	0
One man is turning on the microwave	A man is pushing the buttons of a microwave	1
A flute is being played by a girl	A flute is being put away by a girl	0
One woman is practicing with a flute	One woman is playing a flute	1
A boy is happily playing the piano	One boy is happily playing a piano	1
The boy isn't playing the piano happily	A boy is happily playing the piano	0
A boy is happily playing the piano	A piano is being played by a person	1
A cheetah is quickly running behind its prey.	The cheetah is running quickly behind its prey	1
A cheetah is quickly running behind its prey.	There is no cheetah quickly running behind its prey	0
A cheetah is quickly running behind its prey.	A prey is quickly running behind the cheetah	0
A cheetah is chasing its prey across a field	There is no cheetah quickly running behind its prey	0
A lion is pacing tiredly in a pen	The lion is pacing tiredly in the pen	1
A lion is slowly walking	A lion is slowly moving around	1
The lion is pacing tiredly in the pen	A lion is slowly walking	1
The person isn't dicing up an orange pepper	The person is dicing up a pepper which is orange	0
There is no cook slicing some bell peppers	The person is dicing up a pepper which is orange	0
Some tofu is being sliced by one woman	Tofu is being sliced by a woman	1
Tofu is being sliced by a woman	Tofu isn't being sliced by a woman	0
One man is sitting steadily on the chair	One man is sitting on the chair	1
The man is carelessly smearing butter on a slice of garlic bread	The man isn't smearing butter on bread 	0
A man is spreading butter on a piece of bread which is big	A piece of bread, which is big, is having butter spread upon it by a man OR A piece of bread, which is big, is being spread with butter by a man	1
The parrot is talking into the microphone	There is no parrot speaking	0
A parrot is speaking	The parrot is silent in front of the microphone	0
The food on the trays isn't being eaten by the kittens	The food on the trays is being eaten by the kittens	0
The kittens are eating the food on the trays	Some kittens are eating	1
The food on the trays isn't being eaten by the kittens	Some kittens are eating	0
The food on the trays is being eaten by the kittens	Some kittens are eating	1
A person is singing and playing the guitar	There is no person singing and playing the guitar	0
A man is passionately playing a guitar	One man is passionately playing the guitar	1
Some animals are playing wildly in the water	A few animals are playing in the water	1
The windows are being polished by a man	The windows are being cleaned by a man	1
The windows are being cleaned by a man	There is no window being cleaned by a man	0
The man is driving a car carefully	The man is driving a car	1
The baby is being put into a trash can by a woman	A woman is putting the baby into a trash can	1
There is no baby being put into a trash can by a woman	The baby is being put into a trash can by a woman	0
One small child is greedily drinking water from the cup	One small child is drinking water from the cup	1
The band is singing 	The band isn't singing	0
The woman is happily playing a guitar, which is acoustic, and singing	The woman is playing a guitar, which is acoustic, and singing	1
The woman is happily playing a guitar, which is acoustic, and singing	A person is playing a guitar and singing	1
The singer is playing the guitar at an acoustic concert for a woman	A person is playing a guitar and singing	1
Nobody is playing the guitar and singing	The woman is playing a guitar, which is acoustic, and singing	0
There is no water being drunk by a cat	Some water is being drunk by a cat	0
A young woman is playing the guitar	A girl is playing the guitar	1
A girl is playing the guitar	A girl is not playing the guitar	0
One man is intensely playing a guitar	The man is intensely playing the guitar	1
The man is intensely playing the guitar	The man isn't intensely playing the guitar	0
A man is riding a motorbike	A man is driving a motorbike	1
A magic trick is being performed by the magician	The man is doing a magic trick	1
The man isn't doing a magic trick	The man is doing a magic trick	0
The man is practicing the guitar	The person is practicing the guitar	1
The boy is enthusiastically playing in the mud	The boy is playing in the mud	1
The boy is playing in the mud	The boy isn't playing in the mud	0
A lady is cutting up some meat precisely	A lady is cutting up some meat	1
There is no lady cutting up some meat	Some meat is being cut into pieces by a woman	0
A boy in his teens is talking to a girl with an internet camera	A boy in his teens is talking to a girl with a webcam	1
One man is talking to a girl with an internet camera	One man is chatting with a girl with an internet camera	1
Eggs are being strongly whisked in a bowl by a person	A person is strongly whisking eggs in a bowl	1
A woman is beating two eggs in a bowl and using a whisk made of wire	One woman is beating two eggs in the bowl and using a whisk made of wire	1
A woman is beating two eggs in a bowl and using a whisk made of wire	There is no woman beating two eggs in a bowl and using a whisk made of wire	0
A person is strongly whisking eggs in a bowl	There is no woman beating two eggs in a bowl and using a whisk made of wire	0
A woman is beating two eggs in a bowl and using a whisk made of wire	Eggs are being strongly whisked in a bowl by a person	1
A woman is beating two eggs in a bowl and using a whisk made of wire	A person is strongly whisking eggs in a bowl	1
An interview is being granted by the man	The man is granting an interview	1
A white car is being driven by the man	A person is driving the white car	1
There is no white car being driven by the man	A white car is being driven by the man	0
There is no rope being climbed by a man	A rope is being climbed by a man	0
A man is mindlessly slicing the carrot with a machine	A man is slicing the carrot with a machine	1
The cat is licking milk from a saucer	The cat isn't licking milk from a saucer	0
Some milk is being hungrily drunk by a cat	The cat is hungrily drinking milk	1
There is no cat hungrily drinking milk	The cat is hungrily drinking milk	0
The cat is licking milk from a saucer	There is no cat hungrily drinking milk	0
A woman is peeling a potato	A potato is being peeled by a woman	1
The man is slicing some potatoes	The man is slicing potatoes	1
The man is setting up the camera and taking sunset pictures at the beach	The man is putting away the camera and walks away from the beach	0
A woman is using a machine made for sewing	A woman is using a sewing machine	1
A woman is using a sewing machine	There is no woman using a sewing machine	0
A woman is sewing with a machine	There is no woman using a sewing machine	0
A woman is using a sewing machine	A woman is sewing with a machine	1
An egg is being cracked into a bowl by a woman	A woman is cracking an egg into a bowl	1
A woman is cracking an egg into a bowl	There is no woman cracking an egg into a bowl	0
The woman is cracking two eggs into a glass bowl	The woman is not cracking two eggs into a glass bowl	0
The woman is cracking two eggs into a bowl made of glass	A woman is cracking an egg into a bowl	1
The woman is cracking two eggs into a glass bowl	There is no woman cracking an egg into a bowl	0
The woman is cracking two eggs into a glass bowl	A woman is cracking an egg into a bowl	1
People are playing cricket	Some people are playing cricket	1
A few men are cheerfully playing cricket	People are playing cricket	1
A man is sprinkling seasoning on several sliced and buttered loaves of bread	There is no man sprinkling seasoning on several sliced and buttered loaves of bread	0
A man is putting garlic on some slices of bread	A man is sprinkling seasoning on several sliced and buttered loaves of bread	1
Two kids are playing in a swimming pool with a green colored crocodile float	Two kids are playing in a swimming pool with a crocodile float that is green	1
An inflatable crocodile is being pushed by two kids in a pool	Two kids are pushing an inflatable crocodile in a pool	1
Someone is falling off the horse	Someone is falling off a horse	1
The man is abruptly knocked off of a horse	The man is being knocked off of a horse	1
The man is being knocked off of a horse	Someone is falling off the horse	1
A woman is tapping her fingers nervously	A woman is tapping her fingers	1
A woman is tapping her fingers on a desk	A woman is tapping her fingers on a table	1
There is no woman tapping her fingers	A woman is tapping her fingers on a table	0
A woman is tapping her fingers on a table	A woman is tapping her fingers	1
A dog is pushing a toddler into a rain puddle	A dog is pushing a toddler into a puddle of rain	1
The dog is not knocking the boy into the water	The dog is knocking a boy into the water	0
A dog is pushing a toddler into a puddle of rain	The dog is knocking a boy into the water	1
There is no man eating a bowl of cereal	A man is eating a bowl of cereal	0
A man is eating a bowl of cereal	Cereal is being eaten by the man	1
There is no man eating cereal	A man is eating a bowl of cereal	0
A man is hungrily eating a bowl of cereal	The man is eating cereal	1
The man is eating cereal	There is no man eating a bowl of cereal	0
The woman is adding sugar to the meat slowly	The woman is adding sugar to the meat	1
The woman is adding sugar to the meat	A woman is adding spices to some meat	1
A dog is opening a can of food	A dog is biting a can	1
A cat is playing with a watermelon	One cat is playing with a watermelon	1
A cat is playing with a watermelon	The cat isn't playing with a watermelon	0
One cat is playing with a watermelon	The cat is playing with a watermelon	1
The cat is playing with a watermelon	There is no cat playing with a watermelon	0
The boy is playing a guitar	A boy is playing a guitar	1
The boy is playing a guitar	A kid is playing a guitar	1
A boy is playing a guitar	A kid is playing a guitar	1
The woman is waterskiing fearlessly	The woman is waterskiing	1
The woman is waterskiing	The woman is not waterskiing	0
A woman is wakeboarding on a lake	The woman is not waterskiing	0
Someone is banging the lens of a camera against a nail	Someone is banging a camera lens against a nail	1
Someone is banging a camera lens against a nail	There is no one banging a camera lens against a nail	0
Someone is banging a camera lens against a nail	The man is not hammering a nail with a camera	0
Someone is banging the lens of a camera against a nail	The man is hammering a nail with a camera	1
A person is slicing an onion	A person is cutting an onion	1
There is no person cutting an onion	A person is cutting an onion	0
The oriental lady is cutting a carrot into thin pieces	The oriental lady is not cutting a carrot into thin pieces	0
The oriental lady is cutting a carrot into pieces that are thin	A woman is slicing a carrot	1
There is no woman slicing a carrot	The oriental lady is cutting a carrot into thin pieces	0
The lady is adding cheese to the sauce	The woman is removing cheese from the sauce	0
The tall person is setting fire to the cameras	The person is setting fire to the cameras	1
There is no person setting fire to the cameras	A person is burning some cameras with a blow torch	0
A man is playing the guitar	One man is playing the guitar	1
A man is playing the guitar	There is no man playing the guitar	0
The man is playing an acoustic guitar	One man is playing the guitar	1
The man is playing an acoustic guitar	There is no man playing the guitar	0
A person is cutting an onion into pieces	A person is dicing an onion	1
The man is slicing a potato	The person is slicing the potato	1
Somebody is cutting a tomato	Someone is cutting a tomato	1
The woman is slicing a tomato	Someone is cutting a tomato	1
The woman is not slicing an onion with a knife	The woman is slicing an onion with a knife	0
Some runners are competing in a race	Runners are competing in a race	1
The runners are racing around a track	Runners are not taking part in the race	0
There is no man running down the road	A man is running down the road	0
The man is funnily playing the piano with his nose	The man is playing the piano with his nose	1
The man is funnily playing the piano with his nose	A man is playing the keyboard with his nose	1
There is no man playing the piano with his nose	A man is playing the keyboard with his nose	0
The man is playing the piano with his nose	A man is playing the keyboard with his nose	1
A baby rhino is shunning an adult rhino	A baby rhino is following an adult rhino	0
A baby rhino is walking around a pen with its mother	A rhino, which is little, is following an adult rhino	1
A baby rhino is walking around a pen with its mother	A baby rhino is following an adult rhino	1
A man is riding a motorbike	A man is riding a motorcycle	1
A man is riding a motorcycle through the town	A man is riding a motorbike	1
A man is riding a motorcycle through the town	A man is riding a motorcycle	1
Some persons are singing	A group of people is singing	1
Some people are singing	A few people are singing	1
One man is dancing	A man is dancing	1
A man is carefully climbing a rope	A man is climbing a rope	1
There is no panda climbing	A panda is climbing	0
A woman is dancing beautifully in a cage	A woman is dancing in a cage	1
The woman is dancing	The lady is dancing	1
The woman is dancing	The woman is not dancing	0
Four people are floating on a raft	Nobody is floating on a raft	0
A cat is eating corn on the cob	There is no cat eating corn on the cob	0
A cat is eating some corn	The cat is eating some corn	1
Someone is slicing a tomato	Nobody is slicing a tomato	0
The person is quickly slicing a vegetable	The person is slicing a vegetable	1
The person isn't slicing a vegetable	The person is slicing a vegetable	0
Someone is cutting a tomato	The person is slicing a vegetable	1
Someone is slicing a tomato	The person is slicing a vegetable	1
There is no little girl playing the piano	A little girl is playing the piano	0
There is no little girl playing the piano	A little girl is playing a grand piano on stage	0
A little girl is playing a grand piano on stage	A little girl is playing the piano	1
A man is playing the guitar	A man is playing a guitar	1
A man is playing the guitar	Someone is playing the guitar	1
There is no man playing a bamboo flute	A man is playing a bamboo flute	0
A man is playing a bamboo flute	A flute is being played by the man	1
A man is playing a bamboo flute	The man is not playing a flute	0
A man is playing a flute made of bamboo	The man is playing a flute	1
A person is absently cutting mushrooms with a knife	A person is cutting mushrooms with a knife	1
A person is absently cutting mushrooms with a knife	A person is cutting some mushrooms	1
A person is cutting mushrooms with a knife	A person is cutting some mushrooms	1
A tiger is pacing around a cage	A tiger is walking around a cage	1
A tiger is walking outside a cage	A tiger is walking around a cage	1
A tiger is walking around with no aim	A tiger is walking around aimlessly	1
A monkey is brushing the dog	The monkey is brushing the dog	1
A monkey is brushing the dog	The monkey is not brushing a bull dog	0
The lady is dicing onions	The woman is dicing onions	1
A man is wearing a hard hat and dancing	A man is wearing a hat which is hard and is dancing	1
A man with a hard hat is dancing	The man with a hard hat is dancing	1
There is no man with a hard hat dancing	A man with a hard hat is dancing	0
The man with a hard hat is dancing	A man is wearing a hard hat and dancing	1
A man is wearing a hard hat and dancing	There is no man with a hard hat dancing	0
A man is wearing a hard hat and dancing	A man with a hard hat is dancing	1
Two boys on a couch are playing games on the TV	Two boys are playing a video game	1
Two boys on a couch are playing video games	Two boys are playing a video game	1
The lady is cracking an egg for the mixer	The lady isn't cracking an egg for the mixer	0
The lady is carefully slicing up the meat	The lady is slicing up the meat	1
The lady is slicing up the meat	The lady isn't slicing up the meat	0
Some ferrets are climbing down from a shelf	Ferrets are climbing down from a shelf	1
A few ferrets are climbing out of the cage	Several ferrets are climbing out of the cage	1
A man is getting into an automobile	A man is getting into a car	1
A man is hurriedly getting into a car in a garage	A man is getting into a car in a garage	1
A person is cutting a capsicum into pieces	A capsicum is being cut into pieces by a person	1
A person is cutting a capsicum into pieces	The person is not slicing a clove of garlic into pieces	1
There is no man singing and playing the guitar	The man is singing and playing the guitar	0
The man is singing and playing the guitar	A man is playing a guitar	1
The person is boiling noodles	A person is boiling noodles	1
A person is boiling noodles	There is no person boiling noodles	0
A woman is boiling noodles in water	The person is boiling noodles	1
There is no person boiling noodles	A woman is boiling noodles in water	0
A woman is boiling noodles in water	A person is boiling noodles	1
A karate practitioner is kicking at another man who is wearing protective boxing gloves	A karate practitioner is kicking at another man who is wearing protective gloves for boxing	1
The man is clumsily kick boxing with a trainer	The man is kick boxing with a trainer	1
The man is not kick boxing with a trainer	The man is kick boxing with a trainer	0
The man is kicking a boxing trainer	The man is kick boxing with a trainer	1
A woman on a boulder is lying on a blanket and reading a book	A woman on a rock is lying on a blanket and reading a book	1
The woman is playing a guitar which is electric	The woman is playing an electric guitar	1
The woman is cracking eggs into a bowl	Eggs are being cracked into a bowl by the woman	1
The lady is breaking eggs that are raw into a bowl	The woman is cracking eggs into a bowl	1
A soccer player is scoring a goal	A player of soccer is scoring a goal	1
Soccer players are kicking a soccer ball into the goal	There are no soccer players kicking a soccer ball into the goal	0
A soccer player is scoring a goal	There are no soccer players kicking a soccer ball into the goal	0
A player of soccer is scoring a goal	Soccer players are kicking a soccer ball into the goal	1
A man and a woman are eating	A man and a woman are not eating	0
A man and woman are talking	A man and a woman are silent	0
There is no person pouring olive oil into a pot on the stove	A person is pouring olive oil into a pot on the stove	0
A person is pouring olive oil into a pot on the stove	A person is pouring oil for cooking into a pot	1
A person is pouring oil made with olives into a pot on the stove	A person is pouring cooking oil into a pot	1
A person is pouring olive oil into a pot on the stove	A person is pouring cooking oil into a pot	1
The woman is not walking the dog	The woman is walking the dog	0
A woman is walking the dog down the street	The dog is being walked by the woman	1
A woman is walking the dog down the street	The woman is walking the dog	1
A guinea pig is devouring a carrot	A guinea pig is eating a carrot	1
A small guinea pig is gnawing and eating a piece of carrot on the floor	There is no small guinea pig gnawing and eating a piece of carrot on the floor	0
A small guinea pig is gnawing and eating a piece of carrot on the floor	A guinea pig is eating a carrot	1
The woman is slicing an onion	An onion is being sliced by the woman	1
The plane is landing	A plane is landing	1
A cartoon airplane is landing	An animated airplane is landing	1
A cartoon airplane is landing	A plane is landing	1
An animated airplane is landing	The plane is landing	1
An animated airplane is landing	A plane is landing	1
A woman is preparing an egg in a skillet	There is no woman preparing an egg in a skillet	0
The girl is using an eye pencil on her eyelid	The girl is using a pencil for the eyes on her eyelid	1
The girl is using an eye pencil on her eyelid	The girl is not using an eye pencil on her eyelid	0
There is no girl playing the piano	A girl is playing the piano	0
A girl, who is little, is playing a grand piano on stage	A little girl is playing a grand piano on stage	1
A little girl is playing a grand piano on stage	A girl is playing the piano	1
The woman is cooking eggs	A woman is cooking eggs	1
The woman is not cooking something	A woman is cooking eggs	0
The woman is cooking eggs	The woman is cooking something	1
A woman is cooking eggs	The woman is cooking something	1
Some cats are playing with each other	The cats are playing with each other	1
Two cats are playfully fighting each other	Two cats are fighting each other	1
Two bikes are being ridden by two people	Two people are riding a bike	1
Nobody is riding a bike	Two people are riding a bike	0
Two people are riding a motorcycle	Two people are driving a motorcycle	1
Two people are stopping on a motorcycle	Two people are riding a bike	1
The man is riding a mechanical bull	The man is riding a bull which is mechanical	1
The man is not riding a mechanical bull	The man is riding a mechanical bull	0
There is no man riding a mechanical bull	The man is riding a mechanical bull	0
A woman is skillfully playing a flute	A woman is playing a flute	1
The woman is playing the flute	The flute is being played by the woman	1
The man is lifting barbells	A man is lifting barbells	1
The man is lifting barbells	Weights are being lifted by the man	1
A man is lifting barbells	The man is lifting weights	1
A man is chopping down a tree with an axe	A person is chopping down a tree with an axe	1
A tree is being cut by a man with an axe	A man is chopping down a tree with an axe	1
A man is cutting a tree with an axe	A person is chopping down a tree with an axe	1
A man is cutting a tree with an axe	A man is chopping down a tree with an axe	1
A girl is applying makeup to her face	The girl is applying makeup to her face	1
A girl is applying makeup to her face	There is no girl applying makeup to her face	0
A lady is putting on makeup	A woman is putting on makeup	1
A girl is applying makeup to her face	There is no woman putting on makeup	0
A herd of deer is crossing the street	One herd of deer is crossing the street	1
The herd of caribous is crossing a road quickly	The herd of caribous is crossing a road	1
The herd of caribous is crossing a road	The herd of caribous is not crossing a road	0
A woman is slicing an onion	An onion is being sliced by a woman	1
There is no woman slicing an onion	A woman is slicing an onion	0
Two men are fighting in a cattle pen	Two men are fighting in a pen for cattle	1
Two men are fighting in a cow pasture	Two men are fighting in a pasture for cows	1
Two men are fighting in a cow pasture	Nobody is fighting in a cow pasture	0
The woman is penciling on eyeshadow	A woman is applying cosmetics to her eyelid	1
A man is eating a banana	A banana is being eaten by a man	1
The man is absently eating a banana by a tree	The man is eating a banana by a tree	1
The man is not eating a banana by a tree	The man is eating a banana by a tree	0
The man is absently eating a banana by a tree	A man is eating a banana	1
The man is eating a banana by a tree	A banana is being eaten by a man	1
A big green ball is knocking a potato	A ball, which is green and big, is knocking a potato	1
A large green colored ball is hitting a potato	A big green ball is knocking a potato	1
A ball, which is green and big, is knocking a potato	A large green ball is hitting a potato	1
A large green ball is hitting a potato	A big green ball is knocking a potato	1
Different teams are playing football on a field	Different football players are teaming on a field	1
Two teams are enthusiastically playing soccer	Different teams are playing football on a field	1
A boy is comfortably sitting in a room and playing a piano by a lamp	A boy is sitting in a room and playing a piano by lamp light	1
A boy is sitting in a room and playing a piano by lamp light	A boy is playing a keyboard	1
A woman is playing an electric guitar	A woman is playing a guitar which is electric	1
There is no woman playing an electric guitar	A woman is playing an electric guitar	0
There is no man in a suit standing at a microphone and singing	A man in a suit is standing at a microphone and singing	0
The man on stage is singing into the microphone	The man on stage isn't singing into the microphone	0
A man in a suit is standing at a microphone and singing	The man on stage is singing into the microphone	1
Some teenage girls are dancing for the camera	Some girls in their teens are dancing for the camera	1
A few children are jumping on a trampoline	Some children are jumping on a trampoline	1
Two boy are playing on a trampoline	Nobody is playing on a trampoline	0
The dog is playing with a plastic container	The puppy is not playing with a plastic container	0
The puppy is playing with a plastic container	The dog is playing with a plastic container	1
The puppy is playing with a plastic container	The dog is playing with a plastic container	1
A man is athletically jumping a wall	A man is jumping a wall	1
A man is jumping off a low wall	A man is jumping a wall	1
A man is pouring oil into a skillet	A man is taking the oil out off a skillet	0
A man is pouring oil into a pan	A man is pouring oil into a skillet	1
A man is talking to the woman who is seated beside him and is driving a car	A woman is driving a car and is talking to the man who is seated beside her	1
A woman is driving a car and is talking to the man who is seated beside her	The woman and the man are travelling by automobile	1
There is no woman driving a car and talking to the man seated beside her	The woman and the man are travelling by car	1
A man is talking to the woman who is seated beside him and is driving a car	The woman and the man are travelling by car	1
The person is brushing a cat	A person is brushing a cat	1
A person is brushing a cat	Nobody is brushing a cat	0
A person is combing the fur of a cat	The fur of a cat is being combed by a person	1
A person is brushing a cat	A person is combing the fur of a cat	1
Three men are dancing	A few men are dancing	1
Three men are dancing	The men are not dancing	0
There is no man eating some food	A man is eating some food	0
The man is eating	The person is eating	1
A man is eating some food	The man is fasting	0
There is no woman using an eye pencil and applying eye liner to her eyelid	A woman is using an eye pencil and is applying eye liner to her eyelid	0
A woman is using an eye pencil and is applying eye liner to her eyelid	A woman is applying cosmetics to her eyelid	1
A baby is sneezing and scaring another baby	A baby is sneezing and frightening another baby	1
The monkey isn't practicing martial arts	The monkey is practicing martial arts	0
A man is cutting a box	A box is being cut by a man	1
A man is cutting a box	There is no man cutting a box	0
The man is cutting the tape on the box	A man is cutting the tape on the box	1
There is no young boy playing a wind instrument	A young boy is playing a wind instrument	0
A man is slowly trekking in the woods	The man is hiking in the woods	1
A man is slicing a tomato	There is no man slicing a tomato	0
A woman is slicing a carrot	A woman is cutting a carrot	1
The woman is stirring meat in a bowl	A lady is mixing a mixture of meat in a bowl	1
The woman is stirring meat in a bowl	There is no lady mixing a meat mixture in a bowl	0
A lady is mixing a meat mixture in a bowl	The woman is stirring meat in a bowl	1
A lemon is being squeezed by a woman	A woman is squeezing a lemon	1
There is no woman squeezing juice out of a lemon	A woman is squeezing a lemon	0
The little cat is playing with a toy	The kitten is playing with a toy	1
A kitten is playing with a blue rope toy	The kitten is not playing with a toy	0
A kitten is playing with a toy made of blue rope	The kitten is playing with a toy	1
A boy is fearfully walking across a bridge	A boy is walking across a bridge	1
A man is walking slowly across a rope bridge	A man is walking slowly across a bridge made of rope	1
A boy is hanging a fishing rod and running in front of a fish 	A boy is hanging a rod for fishing and running in front of a fish	1
A woman is boiling eggs	Eggs are being boiled by a woman	1
A woman is placing two eggs into a pot of water	A woman is boiling eggs	1
A man is playing the guitar	The man is playing the guitar	1
A man is playing the guitar	A guitar is being played by a man	1
A man is playing the guitar	Nobody is playing the guitar	0
The soccer player is kicking the ball between somebody's legs	A person is kicking a ball for a soccer game between somebody's feet	1
There is no person kicking a soccer ball between somebody's feet	The soccer player is kicking the ball between somebody's legs	0
The boy, who is young, is running through the ocean waves	The young boy is running through the ocean waves	1
The young boy is running through the ocean waves	The young boy is not running through the ocean waves	0
The boy, who is young, is running through the ocean waves	A child is running in and out of the ocean waves	1
The young boy is running through the ocean waves	A child is running in and out of the waves of the ocean	1
The young boy is running through the ocean waves	A child is running in and out of the ocean waves	1
A woman is coating a pork chop	A cook is coating a pork chop	1
A woman is coating a pork chop	There is no woman coating a pork chop	0
A woman is grating carrots	Carrots are being grated by a woman	1
The man and woman are strolling	The man and woman are walking	1
The man and woman are not walking	The man and woman are walking	0
A man is walking a woman through the woods	The man and woman are walking	1
The south African plane is flying in a blue sky	An airplane is flying through the air	1
There is no woman cooking a breaded pork chop	A woman is cooking a breaded pork chop	0
There is no woman cooking a breaded pork chop	The woman is frying a breaded pork chop	0
The woman is frying a breaded pork chop	A woman is cooking a breaded pork chop	1
The woman is slicing herbs	The woman is not slicing herbs	0
A man is standing on a roof top and playing a violin	A man is standing on a roof	1
There is no one typing	Someone is typing	0
There is no one typing	Someone is typing on a keyboard	0
A woman is peeling a potato	A potato is being peeled by a woman	1
A potato is being peeled by a woman	A woman is peeling a potato	1
A woman is peeling a potato	There is no woman peeling a potato	0
Someone is cleaning an animal	Someone is cleansing an animal	1
Someone is cleaning an animal	Someone is dirtying an animal	0
A woman is cleaning a shrimp	Someone is cleansing an animal	1
The woman is cleaning a shrimp	Someone is cleaning an animal	1
A woman is cleaning a shrimp	Someone is cleaning an animal	1
There is no woman riding a water scooter	A woman is riding a water scooter	0
The boy is speedily riding a tricycle	The boy is riding a tricycle	1
There is no panda bear eating some bamboo	A panda bear is eating some bamboo	0
One panda is eating a bamboo cane	The panda is eating bamboo	1
A panda bear is eating some bamboo	The panda is not eating bamboo	0
The woman is stirring eggs in a bowl	The lady is stirring eggs in a bowl	1
The woman is stirring eggs in a bowl	The woman isn't stirring eggs in a bowl	0
Nobody is beating an egg	The woman is stirring eggs in a bowl	0
A person is unfolding a tortilla	A person is folding a tortilla	0
The man is catching a fish	A man is catching a fish	1
A woman is carefully deboning a fish	A woman is deboning a fish	1
A man is playing a harp	The man is playing a harp	1
A person is wiping butter on a tray	A person is spreading butter on a tray	1
A person is buttering a tray	A person is spreading butter on a tray	1
A person is wiping butter on a tray	There is no person buttering a tray	0
A woman is being handed volleyballs by another woman	One woman is handing volleyballs to another woman	1
One man is chopping a log with an axe	A man is chopping a log with an axe	1
A man is chopping a log with an axe	There is no man chopping a log with an axe	0
The man is chopping the trunk of a tree with an axe	The man is chopping a tree trunk with an axe	1
The man is not chopping a tree trunk with an axe	The man is chopping a tree trunk with an axe	0
There is no man playing a guitar	A man is playing a guitar	0
A man is strumming a guitar	A man is playing a guitar	1
A man is playing a guitar	There is no man playing a guitar	0
The man is thinking	A man is thinking	1
A man is thinking	There is no man thinking	0
A cat with a white coat, perched on a small wooden cabinet, is looking outside the window	A white cat perched on a small wooden cabinet is looking outside the window	1
The cat perched on the table isn't looking out the window	The cat perched on the table is looking out the window	0
A white cat perched on a small wooden cabinet is looking outside the window	The cat perched on the table is looking curiously out the window	1
A white cat perched on a small wooden cabinet is looking outside the window	The cat is looking out the window at the table on the perch	1
There is no dog licking a baby	A dog is licking a baby	0
A woman is slicing garlic	A woman is chopping up garlic	1
The woman is not dicing garlic	The woman is dicing garlic	0
A woman is chopping up garlic	Garlic is being diced by the woman	1
The woman is dicing garlic	A woman is slicing garlic	1
A woman is chopping up garlic	The woman is dicing garlic	1
A woman is dancing	There is no woman dancing	0
The man is not dancing	The man is dancing	0
The person is writing with a pencil	The person is writing	1
Somebody is boiling okra in a pot	Someone is boiling okra in a pot	1
Nobody is cooking okra in a pan	Someone is cooking okra in a pan	0
The man is dancing	A man is dancing	1
A man is speaking	There is no man speaking	0
A squirrel is spinning around in circles	There is no squirrel spinning around in circles	0
A squirrel is lying down	A squirrel is running around in circles	0
A squirrel is crazily spinning around in circles	A squirrel is running around in circles	1
Paper is being cut with scissors	There is no paper being cut with scissors	0
The piece of paper is being cut	Some paper is being cut	1
The piece of paper is not being cut	The piece of paper is being cut	0
Some paper is being cut	Paper is being cut with scissors	1
Someone is cutting some paper with scissors	The piece of paper is being cut	1
Paper is being cut with scissors	The piece of paper is being cut	1
The man is skillfully playing the guitar	The man is playing a guitar	1
A man is playing a flute	The man is not playing the guitar	1
A man is playing the drums	The drums are being played by a man	1
A man is playing the drums	A man is playing the drum	1
The man is doing floor exercises	A man is doing exercises	1
A monkey is riding a bike	There is no monkey riding a bike	0
The fish are immobile	A fish is swimming	0
Some fish are swimming	A fish is swimming	1
A woman is clumsily putting meat in a pan	A woman is putting meat in a pan	1
The meat is being dropped into a pan	The meat is not being dropped into a pan	0
A woman is putting meat in a pan	Someone is dropping the meat into a pan	1
A man is holding a frog	A person is holding a frog	1
The woman is handling a frog	The woman is not handling a frog	0
The boys are standing in front of the car, which is burning	The boys are standing in front of the burning car	1
There is no boy filling a pitcher with water	A boy is filling a pitcher with water	0
A man and a woman are walking nicely	A man and a woman are walking	1
A man is strolling in the rain	A man is walking in the rain	1
There is no man walking in the rain	A man is walking in the rain	0
The men are packing suitcases into the trunk of a car	The men are not packing suitcases into the trunk of a car	0
The men are carefully putting suitcases into the trunk of a car	The men are putting suitcases into the trunk of a car	1
The men are not putting suitcases into the trunk of a car 	The men are putting suitcases into the trunk of a car	0
The men are carefully putting suitcases into the trunk of a car	The men are packing suitcases into the trunk of a car	1
The men are not putting suitcases into the trunk of a car 	The men are packing suitcases into the trunk of a car	0
The men are putting suitcases into the trunk of a car	The men are placing suitcases in the trunk of a car	1
The men are putting suitcases into the trunk of a car	The men are not packing suitcases into the trunk of a car	0
A woman is putting on eyeshadow	Eyeshadow is being put on by a woman	1
A woman is putting make-up on	The woman is putting make-up on	1
A woman is putting make-up on	The woman is removing make-up	0
A woman is putting on eyeshadow	The woman is putting make-up on	1
Eyeshadow is being put on by a woman	A woman is putting make-up on	1
A woman is putting on eyeshadow	A woman is putting make-up on	1
A toy train is violently striking a toy car	A toy train is striking a toy car	1
A toy train is striking a toy car	A toy train is hitting a toy car	1
A toy train is striking a toy car	A toy train is hitting a toy car	1
The person is peeling an onion	A person is peeling an onion	1
A person is peeling an onion	There is no person peeling an onion	0
The person is slicing onions	The person is peeling an onion	0
A man is putting down the guitar	A man is playing a guitar	0
A woman is playing a guitar	A guitar is being played by a woman	1
A boy is looking at a calendar	A boy is staring at a calendar	1
A boy is looking at a calendar	There is no boy looking at a calendar	0
The boy is studying a calendar	A boy is studying a calendar	1
A boy is studying a calendar	A boy is staring at a calendar	1
A boy is looking at a calendar	A boy is studying a calendar	1
A person is stupidly throwing a cat at the ceiling	A person is throwing a cat at the ceiling	1
A person is throwing a cat at the ceiling	A cat is thrown at the ceiling by a person	1
A person is stupidly throwing a cat at the ceiling	A person is throwing a cat at the ceiling	1
There is no person throwing a cat at the ceiling	A person is throwing a cat at the ceiling	0
The woman is taking up and holding a baby kangaroo	The woman is picking up and holding a baby kangaroo	1
The woman is picking up and holding a baby kangaroo	A woman is picking up and holding a kangaroo, which is a baby, in her arms	1
The woman is picking up and holding a baby kangaroo	A woman is picking up and holding a baby kangaroo in her arms	1
A woman is dancing and a man is playing the keyboard	The woman is dancing and a man is playing the keyboard	1
A woman is gracefully dancing on a stage	A woman is dancing on a stage	1
A woman is scrubbing a zucchini with a brush for vegetables	A person is scrubbing a zucchini	1
A woman is scrubbing a zucchini with a vegetable brush	A person is scrubbing a zucchini	1
A man in a cap is playing a harp	A man in a hat is playing a harp	1
A man is playing a guitar	A man is playing an instrument	1
A concentrated woman is playing flute	A woman is playing flute	1
The woman is playing a flute	A woman is playing a flute	1
A woman is playing flute	The woman is playing a flute	1
A woman is playing a flute	A woman is playing flute	1
The man is riding a horse by a creek	The man is riding a horse by a stream	1
A horse is being ridden in a creek by a man	The man is riding a horse by a creek	1
A horse is being ridden in a creek by a man	A man is riding a horse	1
The man is riding a horse by a creek	A horse is being ridden by a man	1
The cat is playing keyboards	A cat is playing keyboards	1
A cat is playing keyboards	There is no cat playing keyboards	0
A cat is playing a piano	A cat is playing keyboards	1
The man is walking along a path through the wilderness	The man is walking along a track through the wilderness	1
The man is walking along a path through the wilderness	The man is not walking along a path through the wilderness	0
The man is rising from a swamp	A man is coming out of the water	1
A man is dancing upside-down on the ceiling	A man is dancing on the ceiling of a room	1
A man is dancing	A male is dancing	1
There is no man dancing	A man is dancing	0
A man is singing passionately	A man is singing	1
The man is singing heartily and playing the guitar	The man is singing and playing the guitar	1
A few people are dancing	A group of people are dancing	1
The women are divinely dancing outside	The women are dancing outside	1
The women are not dancing outside	The women are dancing outside	0
The women are dancing outside	A group of people are dancing	1
Two men are doing a funny skit with a boxer in front of a crowd of people	Two men are doing a skit, which is very funny, with a boxer in front of a crowd of people	1
The boy is checking a calendar	A boy is checking a calendar	1
A boy is checking a calendar	There is no boy checking a calendar	0
A boy is attentively looking at a calendar	A boy is looking at a calendar	1
A boy is attentively looking at a calendar	A boy is checking a calendar	1
The boy is checking a calendar	A boy is looking at a calendar	1
A boy is checking a calendar	A boy is looking at a calendar	1
The men are fighting with their fists in a ring	The men are fist fighting in a ring	1
The men are fist fighting in a ring	Two people are fist fighting in a ring	1
The men are fist fighting in a ring	Nobody is fist fighting in a ring	0
The men are fighting with their fists in a ring	Two men are fist fighting in a ring	1
Two men are fist fighting in a ring	The men are fist fighting in a ring	1
The boy is not riding a bike on the top of a metal fence	The boy is riding a bike on the top of a metal fence	0
The boy is riding a bike on the top of a fence made of metal	A biker is riding along the top of a fence	1
A child is slowly waking up	A child is waking up	1
A child is waking up	There is no child waking up	0
A girl is awakening	A child is waking up	1
A girl is waking up	A child is waking up	1
A boy is skillfully playing a piano	A boy is playing a piano	1
A man is singing and playing a guitar	A person is singing and playing a guitar	1
A man is singing and playing a guitar	There is no man singing and playing a guitar	0
A man is climbing up a rope	The man is climbing up a rope	1
The woman is picking up a kangaroo that is little	The woman is picking up a baby kangaroo	1
The woman is picking up a baby kangaroo	The woman is not picking up a baby kangaroo	0
The woman is picking up the kangaroo	The kangaroo is picking up the woman	0
The woman is picking up a kangaroo that is little	The woman is picking up the kangaroo	1
There is no man breaking wooden boards with his hand	A man is breaking wooden boards with his hand	0
A person is riding a jetski in the waves	The person is riding a jetski in the waves	1
A person is riding a jetski in the waves	There is no person riding a jetski in the waves	0
A Seadoo is being ridden by a woman	A woman is riding a Seadoo	1
A woman is riding a Seadoo	There is no person riding a jetski in the waves	0
A man is dancing	A person is dancing	1
A man is slowly dancing on the road	A man is dancing on the road	1
A man is slowly dancing on the road	A man is dancing	1
A man is running on the road	The man is running on the road	1
A man is outside and is throwing blades at a target which is close	A man is outside and is throwing blades at a close target	1
A horse is being ridden by a man	A man is riding a horse	1
One man is riding a horse	The man is riding a horse	1
The man is riding a horse	A man is riding a horse	1
A picture is being drawn by a man	A man is drawing a picture	1
Someone is drawing a person	The person is drawing	1
A picture is being drawn by a man	The person is drawing	1
Someone is playing the guitar	Somebody is playing the guitar	1
There is no man eating food	A man is eating some food	0
A man is eating a pizza	A pizza is being eaten by a man	1
A man is eating a pizza	Some food is being eaten by a man	1
A man is eating a pizza	A man is eating some food	1
A cute panda is lying down	A cute panda is not lying down	0
The panda bear is resting on the logs	The panda bear is lying on the logs	1
The panda bear is lying on the logs	The panda bear is not lying on the logs	0
The log is lying on the panda bear	The panda bear is lying on the logs	0
The panda bear is lying on the logs	A cute panda is not lying down	0
A dog is jumping on a trampoline	A dog is bouncing on a trampoline	1
There is no dog bouncing on a trampoline	A dog is jumping on a trampoline	0
A man is doing back flips on a trampoline	A man is jumping on a trampoline	1
There is no man doing back flips on a trampoline	A man is doing back flips on a trampoline	0
A woman is slicing an onion	A woman is cutting an onion	1
There is no woman cutting an onion	A woman is cutting an onion	0
A woman is cutting meat	A woman is slicing some meat	1
A woman is cutting meat	A woman is not cutting meat	0
A woman is cutting meat	There is no woman cutting an onion	1
A man is playing a wooden flute	A wooden flute is being played by a man	1
The man is cleaning the drawing on the board	The man is erasing the drawing on the board	1
The man is erasing the other man's work from the board	The man is erasing the other man's work from the panel	1
There is no woman cutting a vegetable	A woman is cutting a vegetable	0
An eggplant is being sliced by a woman	A woman is slicing an eggplant	1
An eggplant is being sliced by a woman	A woman is cutting a vegetable	1
A woman is slicing an eggplant	A woman is slicing a vegetable	1
A woman is slicing an eggplant	There is no woman cutting a vegetable	0
A dog is eating a doll	A dog is biting a doll	1
A dog is playing with a toy	A dog is having fun with a toy	1
A man is dancing	There is no man dancing	0
A man is praying fervently	A man is praying	1
There is no man praying	A man is praying	0
There is no man slicing some bread	A man is slicing some bread	0
A man is slicing some bread	A man is cutting a slice of bread	1
A man is slicing bread	A person is slicing a piece of bread	1
A man is slicing some bread	A person is slicing a piece of bread	1
Someone is scratching the belly of an animal	Someone is stroking the belly of an animal	1
Someone is stroking the belly of an animal	A woman is stroking a lemur	1
A lemur is eating quickly	A lemur is eating	1
A lemur is eating	There is no lemur eating	0
The animal with big eyes is voraciously eating	The animal with big eyes is eating	1
Guitar is being played by two men	Two men are playing guitar	1
A man is playing a flute	There is no man playing a flute	0
A man is playing an electronic keyboard	An electronic keyboard is being played by a man	1
A song is being sung by a clown	A clown is singing	1
There is no clown singing	A clown is singing	0
A clown is singing and people are dancing	A costumed performer is singing and people are dancing	1
There is no clown singing and people are not dancing	A clown is singing	0
A clown is singing and people are dancing	A song is being sung by a clown	1
The horse is being ridden by the girl	The girl is riding the horse	1
The girl is spraying the plants with water	The girl is watering the plants	1
A man is rapidly chopping some mushrooms with a knife	A man is quickly chopping some mushrooms with a knife	1
There is no man rapidly chopping some mushrooms with a knife	A man is rapidly chopping some mushrooms with a knife	0
A person is not quickly chopping mushrooms with a knife	A person is quickly chopping mushrooms with a knife	0
A man is quickly chopping some mushrooms with a knife	A person is quickly chopping mushrooms with a knife	1
A person is quickly chopping mushrooms with a knife	A man is rapidly chopping some mushrooms with a knife	1
A man and a woman are shaking hands	Two persons are shaking hands	1
An old woman is shaking hands with a man	An woman that is old is shaking hands with a man	1
An woman that is old is shaking hands with a man	A man and a woman are shaking hands	1
A young woman is shaking hands with a man	A man and a woman are shaking hands	1
An old woman is shaking hands with a man	A man and a woman are not shaking hands	0
An old woman is shaking hands with a man	A man and a woman are shaking hands	1
A woman is chopping up an octopus	A woman is cutting an octopus	1
The woman is cutting cooked octopus	A woman is cutting an octopus	1
There is no woman chopping up an octopus	The woman is cutting cooked octopus	0
An airplane is taking off	An aircraft is taking off	1
An airplane is taking off	A plane is taking off	1
A woman is riding a horse	A woman is riding an animal	1
A woman is not riding a horse	A woman is riding a horse	0
A man is cutting a potato	There is no man cutting a potato	0
A man is making a sketch	A man is drawing	1
A man is making a sketch	The man is drawing	1
Someone is peeling a banana	Someone is removing the peel of a banana	1
A dog is barking noisily	A dog is barking	1
A jet is not flying	A jet is flying	0
A man is cutting a paper	There is no man cutting a paper	0
A person is not tearing paper	A person is tearing paper	0
A man is tying a shoe	A man is tying the shoe	1
A shoe is being tied by a man	A man is tying a shoe	1
A guy is not riding a horse	A guy is riding a horse	0
A man is riding a horse in a sandy land	A guy is riding a horse	1
A man is riding a horse on the beach	A guy is riding a horse	1
A man is riding a horse in the desert	A horse is being ridden by a guy	1
A paper plate is being cut by a man	A man is cutting a paper plate	1
The man is not cutting a paper plate	The man is cutting a paper plate	0
Two men are competing in a tire rolling race	Two men are racing in a tire rolling competition	1
There are no people flipping the tires of a tractor	Two people in a race are flipping the tires of a tractor	0
There is no man patting an alligator on the mouth	A man is patting an alligator on the mouth	0
A person is dropping chopped vegetables into a pot on the stove	Chopped vegetables are being dropped into a pot on the stove by a person	1
The men are not talking	The men are talking	0
A man is phoning	A man is talking on the phone	1
A man is talking on the phone	A man is not talking on the phone	0
The rhino is grazing on the grass	The rhino is being fed on the grass	1
The rhino is grazing on the grass	A animal is grazing in a field	1
A man and a woman are running together and holding hands	A couple is running towards the ocean	1
The content of a bowl is being mixed by a man	A man is mixing the content of a bowl	1
The woman is pouring oil into the pan	Oil is being poured into the pan by the woman	1
A girl is brushing her hair	A girl is styling her hair	1
The doctors are healing a man	The doctors are reviving a man	1
The doctors are reviving a man	The doctors are not reviving a man	0
The doctors are reviving a man	The doctor is helping the patient	1
There is no man massaging a woman	A man is massaging a woman	0
There is no man screwing a piece of wood to a wall	A man is screwing a piece of wood to a wall	0
A man is playing a flute	A flute is being played by a man	1
A man is driving a car	A man is driving a vehicle	1
A man is riding a horse	There is no man riding a horse	0
A cat is sliding upside down under a couch	An animal is crawling under a piece of furniture	1
A horse is being ridden by a man	A man is riding a horse	1
A man is emptying a container made of plastic	A man is emptying a plastic container	1
A man is shaking a container over a sink in the kitchen	There is no man shaking a container over a sink in the kitchen	0
Some men are fighting	A group of men is fighting	1
Two men are battling	Two men are fighting	1
Two men are not fighting	Two men are fighting	0
There are no men fighting	Two men are fighting	0
Two men are fighting	Some men are fighting	1
Two women are happily dancing	Two women are dancing	1
Two women are dancing	Two women are not dancing	0
A horse is being ridden by a woman	A woman is riding a horse	1
A woman is riding a horse	A woman is not riding a horse	0
A woman is riding a horse	There is no woman riding a horse	0
There is no hamster singing	A hamster is singing	0
There is no man singing and playing a guitar	A man is singing and playing a guitar	0
There is no man playing a guitar	A man is singing and playing a guitar	0
A man is singing and playing a guitar	A man is playing a guitar	1
A man is driving a car	A man is driving a vehicle	1
There is no man driving a car	A man is driving a car	0
A boy is cutting grass with scissors	A kid is cutting grass with scissors	1
There is no boy cutting grass with scissors	A boy is cutting grass with scissors	0
The boy is cutting the grass by the curb with scissors	The boy is not cutting the grass by the curb with scissors	0
A man is playing a violin	There is no man playing a violin	0
A man is playing a harp	A harp is being played by a man	1
There is no man playing a harp	A man is playing a harp	0
A keyboard is being played by a man	A man is playing a keyboard	1
There is no man playing a keyboard	A man is playing a keyboard	0
A man is cutting a cord with a sword	A man is cutting a rope with a sword	1
There is no man cutting a rope with a sword	A man is cutting a rope with a sword	0
A man is cutting a thick rope with a sword	A man is cutting a rope with a sword	1
A man is removing the peel of an onion	A man is peeling an onion	1
There is no man peeling an onion	A man is peeling an onion	0
There is no woman cutting a potato	A woman is cutting a potato	0
An onion is being sliced by a woman	A woman is slicing an onion	1
There is no woman slicing an onion	A woman is slicing an onion	0
A man is drilling a hole in a piece of wood	A man is closing a hole in a piece of wood	0
Someone is drilling a hole in a strip of wood with a power drill	Someone is making a hole in a strip of wood with a drill	1
Nobody is drilling a hole in a strip of wood with a power drill	Someone is drilling a hole in a strip of wood with a power drill	0
Someone is drilling a hole in a strip of wood with a power drill	A man is drilling a hole in a piece of wood	1
A woman is slicing an onion	A woman is cutting an onion	1
A woman is slicing garlic	A woman is cutting garlic	1
A man is showing off a small monkey	A man is holding an animal, which is small, in one hand	1
A group of boys is playing soccer on the seashore	A group of boys is playing soccer on the beach	1
A group of boys is not playing soccer on the beach	A group of boys is playing soccer on the beach	0
A group of men is playing soccer on the beach	A group of men is playing with a ball on the beach	1
Some pieces of butter are being added to the stand mixer	Pieces of butter are being added to the stand mixer	1
There is no butter being added to the stand mixer	Pieces of butter are being added to the stand mixer	0
A man is cutting pieces of butter into a mixing bowl	Pieces of butter are being added to the stand mixer	1
A monkey is kicking a person	A person is being kicked by a monkey	1
There is no monkey kicking a person	A monkey is kicking a person	0
A monkey is practicing martial arts	A chimp is practicing martial arts	1
A man is fixing a silencer to a gun	A man is applying a silencer to a gun	1
There is no man fixing a silencer to a gun	A man is fixing a silencer to a gun	0
A man is fitting a silencer to a pistol	There is no man fitting a silencer to a pistol	0
A man is fitting a silencer to a pistol	There is no man fixing a silencer to a gun	0
A person is performing tricks on a motorcycle	A person is not performing tricks on a motorcycle	0
A man on a motorcycle is riding on one wheel	A person is performing acrobatics on a motorcycle	1
A man on a motorcycle is doing a trick	A person is performing tricks on a motorcycle	1
A man is singing into an old microphone	A man is singing into a microphone	1
A man is cooking a snake	A man is roasting a snake	1
A little boy is playing a guitar	A young boy is playing a guitar	1
A little boy is playing a guitar	There is no boy playing guitar	0
A boy is playing a guitar	A boy is playing an instrument	1
A boy is playing a guitar	A boy is not playing a guitar	0
A guitar is being played by a kid	A kid is playing guitar	1
There is no kid playing guitar	A kid is playing guitar	0
A boy is playing a guitar	A guitar is being played by a kid	1
There is no kid playing guitar	A boy is playing a guitar	0
A monkey is teasing a dog at the zoo	A dog is being teased by a monkey at the zoo	1
A dog's tail is being pulled by a monkey	A monkey is pulling a dog's tail	1
There is no monkey pulling a dog's tail	A monkey is pulling a dog's tail	0
There is no monkey teasing a dog at the zoo	A monkey is pulling a dog's tail	0
A person is slicing some ginger	A person is cutting some ginger	1
A person is slicing an onion	An onion is being sliced by a person	1
A man is not cutting a potato	A man is cutting a potato	0
A man is slicing a potato into pieces	A man is cutting a potato into pieces	1
A man is slicing a potato into pieces	A man is cutting a potato	1
A man is opening a box with a knife	A man is using a knife to open a box	1
A man is playing a guitar	A guitar is being played by a man	1
There is no man playing a guitar	A man is playing a guitar	0
A man is playing an electronic keyboard	An electronic keyboard is being played by a man	1
A man is dancing	A person is dancing	1
A woman is exercising	There is no woman exercising	0
A woman is cutting potatoes	A woman is slicing potatoes	1
A woman is not slicing carrots	A woman is slicing carrots	0
There is no man mixing vegetables in a pot	A man is mixing vegetables in a pot	0
A person is stirring vegetables in a pot	A person is stirring vegetables in a bowl	1
A person is not stirring vegetables in a pot	A person is stirring vegetables in a pot	0
A man is mixing vegetables in a pot	A person is stirring vegetables in a pot	1
A man is doing pull-ups	There is no man doing pull-ups	0
A man is sharpening a knife	A man is sharpening a weapon	1
There is no man playing a guitar	A man is singing and playing a guitar	0
A man is singing and playing a guitar	A man is playing a guitar	1
Someone is putting ingredients into a wok	Someone is not putting ingredients into a wok	0
The military officer is barking at the recruits	An officer is talking to the soldiers	1
The military officer is barking at the recruits	An officer is talking to the recruits	1
A baby elephant is not eating a small tree	A baby elephant is eating a small tree	0
There is no little girl peddling a scooter	A little girl is peddling a scooter	0
A child is walking down the street and a jeep is pulling up	A child is walking down the street and a jeep is stopping	1
A man in a car is pulling up beside a woman that is who along a road	A man in a car is not pulling up beside a woman who is walking along a road	0
A woman is not chopping garlic	A woman is chopping garlic	0
A woman is cutting a fish	A woman is slicing a fish	1
Someone is holding a hedgehog	Someone is holding a small animal	1
Nobody is holding a hedgehog	Someone is holding a hedgehog	0
Something is being fried by a woman	A woman is frying something	1
There is no woman frying something	A woman is frying something	0
An email is being read by a man	A man is reading an email	1
A man is reading an email	There is no man reading an email	0
A person is peeling a banana	A banana is being peeled by a person	1
A big cat is opening a drawer made of plastic with its paws and is jumping inside	A cat is opening a drawer and climbing inside	1
A big cat is opening a plastic drawer with its paws and is jumping inside	A cat is opening a drawer and climbing inside	1
An onion is being sliced by a woman	A woman is slicing an onion	1
A woman is slicing an onion	There is no woman slicing an onion	0
A woman is painting a man's face	A man's face is being painted by a woman	1
A woman is painting a man's face	Makeup is being put on the man by the woman	1
The woman is putting makeup on the man	A man's face is being painted by a woman	1
The woman is putting makeup on the man	A woman is painting a man's face	1
The man is talking on the telephone	The man isn't talking on the telephone	0
The man is talking on the phone	The man is speaking on the telephone	1
The man is not talking on the phone	The man is talking on the telephone	0
A man is slicing onions	A man is cutting onions	1
There is no man cutting onions	A man is cutting onions	0
A man is cutting an onion	An onion is being cut by a man	1
A man is not cutting an onion	A man is cutting an onion	0
A door is being opened by a man	A man is opening a door	1
There is no man cutting a potato	A man is cutting a potato	0
A man is slicing a potato	There is no man slicing a potato	0
A man is slicing a potato	There is no man cutting a potato	0
A woman is playing the violin	There is no woman playing the violin	0
A man is fishing in the river	There is no man fishing in the river	0
Some food is being prepared by a chef	A chef is preparing some food	1
A chef is preparing a meal	There is no chef preparing a meal	0
There is no chef preparing a meal	A chef is preparing some food	0
Two sumo ringers are not fighting	Two sumo ringers are fighting	0
There is no person playing a piano	A person is playing a piano	0
A person is slicing a potato	There is no person slicing a potato	0
There is no man putting some cheese on a pizza	A man is putting some cheese on a pizza	0
There is no man putting some cheese on a pizza	A man is sprinkling shredded cheese on a pizza	0
A man is sprinkling cheese on a pizza	A man is putting some cheese on a pizza	1
There is no man sprinkling shredded cheese on a pizza	A man is putting some cheese on a pizza	0
A man is sprinkling shredded cheese on a pizza	A man is putting some cheese on a pizza	1
There is no man doing a card trick	A man is doing a card trick	0
A man is playing with water	A man is not playing with water	0
A man is buttering a piece of bread	A man is buttering a slice of bread	1
A lemur is hanging on a cord	A lemur is hanging on a rope	1
There is no man pouring cleaner into the sink	A man is pouring cleaner into the sink	0
The drums are being played by the man	The man is playing the drums	1
There is no woman deep frying food	A woman is deep frying food	0
A woman is frying some food	Some food is being fried by a woman	1
A woman is not frying some food	A woman is frying some food	0
A woman is deep frying food	Some food is being fried by a woman	1
A woman is pouring eggs into a frying pan	A woman is removing eggs from a frying pan	0
The child is silent	A boy is saying a word	0
A boy is saying a word	A child is talking	1
Some sticky goo is being pulled out of a bowl by a woman	A woman is pulling some sticky goo out of a bowl	1
The woman is not putting pasta into a dish	The woman is putting pasta into a dish	0
The men are playing soccer	The men are playing with a ball	1
A dog is looking around	An animal is looking around	1
A dog is looking around	There is no dog looking around	0
A dog is looking at a store counter	There is no dog looking around	0
A tiger is walking around	A tiger is not walking around	0
A woman is frying meat	A woman is not frying meat	0
The trumpet is being played by a man	A man is playing the trumpet	1
Nobody is playing with a toad	Someone is playing with a toad	0
The person is riding the horse	The person is not riding the horse	0
A horse is being ridden by a man	The person is riding the horse	1
A man is riding a horse	The person is riding the horse	1
Someone is folding a piece of paper	Nobody is folding a piece of paper	0
Nobody is folding a piece of paper	A person is folding a piece of paper	0
Sign language is being used by a young girl	A girl is communicating with sign language	1
A rabbit is playing with a stuffed bunny	A bunny is playing with a stuffed bunny	1
A rabbit is playing with a toy rabbit	A rabbit is playing with a stuffed bunny	1
A man is jumping rope in a field	A man is jumping rope outside	1
A woman is not slicing a cucumber	A woman is slicing a cucumber	0
The man is not slicing a potato	The man is slicing a potato	0
A potato is being sliced by the man	A man is slicing potatoes	1
The man is slicing a potato	Potatoes are being sliced by a man	1
A wind instrument is being played by a girl	A girl is playing a wind instrument	1
A girl is playing a flute	A wind instrument is being played by a girl	1
A girl is playing a flute	A girl is playing a wind instrument	1
A keyboard is being played by a person	A person is playing a keyboard	1
A person is playing a keyboard	A person is not playing a keyboard	0
Someone is playing piano	Someone is not playing piano	0
A man is jumping into a pool	A man is diving into a pool	1
A man is jumping into a pool	A man is diving into a pool	1
The man is seasoning the sausages	The man is seasoning the meat	1
A man is playing a flute	A flute is being played by a man	1
There is no man playing a flute	A man is playing a flute	0
A man is playing a large flute	A large flute is being played by a man	1
A man is playing a small flute	A man is playing a flute	1
A man is playing a large flute	A flute is being played by a man	1
The lady is peeling the potato	The potato is being peeled by the lady	1
The lady is peeling the potato	There is no lady peeling the potato	0
A woman is peeling a potato	The potato is being peeled by the lady	1
A woman is peeling a potato	There is no lady peeling the potato	0
The lady is peeling the potato	A woman is not peeling a potato	0
The lady is peeling the potato	A woman is peeling a potato	1
A man is playing the guitar	A man is playing the instrument	1
The guitar is being played by a man	A man is playing the guitar	1
A man is playing the guitar	There is no man playing the guitar	0
The man is not putting chicken into the container	The man is putting chicken into the container	0
A man is removing some food from a box	The man is putting chicken into the container	0
The man is putting chicken into the container	A man is putting some food in a box	1
Eggs are being cracked into a bowl by a woman	A woman is cracking eggs into a bowl	1
A woman is placing skewers onto a rack	Skewers are being placed onto a rack by a woman	1
A baby is not playing a guitar	A baby is playing a guitar	0
The little boy is singing and playing the guitar	The little boy is not singing and playing the guitar	0
A woman is peeling a potato	A woman is peeling food	1
There is no woman peeling a potato	A woman is peeling a potato	0
A man is reading the email	A person is reading the email	1
There is no man reading the email	A man is reading the email	0
Someone is reading the email	Someone is not reading the email	0
Someone is reading the email	A person is reading the email	1
A man is reading the email	Someone is reading the email	1
Two baby pandas are playing	Two cubs are playing	1
Two pandas are lying together	Two panda bears are lying together	1
Two baby pandas are playing	Two pandas are not lying together	1
A woman is frying fish	Fish is being fried by a woman	1
A woman is frying fish	A woman is not frying fish	0
A woman is playing the flute	The flute is being played by a woman	1
A man is playing a flute	A man is playing the flute	1
A boy is mowing the lawn	A guy is mowing the lawn	1
A guy is mowing the lawn	There is no guy mowing the lawn	0
Grass is being mowed by a man	A man is mowing grass	1
A guy is mowing the lawn	Grass is being mowed by a man	1
A guy is mowing the lawn	There is no man mowing grass	0
A person is frying meat in a pan	A person is frying food in a pan	1
A person is not holding a skunk	A person is holding a skunk	0
The lady is cracking an egg into a bowl	The lady is cracking an egg into a dish	1
A man is cutting tomatoes	A man is slicing tomatoes	1
Broccoli are being cut by a woman	A woman is cutting broccoli	1
A woman is not cutting broccoli	A woman is cutting broccoli	0
A woman is firing a rifle	A woman is firing a weapon	1
There is no woman firing a rifle	A woman is firing a rifle	0
Guitar is being played by a man	A man is playing guitar	1
A man is drawing some figures	A person is drawing some figures	1
A woman is cutting onions	A woman is chopping onions	1
A woman is cutting onions	There is no woman cutting onions	0
A group of people are dancing at a concert	A group of people are dancing in a show	1
A group of people are not dancing at a concert	A group of people are dancing at a concert	0
The man is feeding the snake with a mouse	The man is feeding the snake with an animal	1
The man is feeding the snake with a mouse	The man is not feeding the snake with a mouse	0
A boy is playing on a toy phone	A boy is playing on a toy	1
The man is aiming a gun	The man is handling a gun	1
The man is aiming a gun	The man is drawing a gun	1
A horse is being ridden by a girl	A girl is riding a horse	1
The girl is trotting on the horse	The person is trotting on the horse	1
There is no girl riding a horse	The girl is trotting on the horse	0
The girl is trotting on the horse	A girl is riding a horse	1
A dog is barking at a ball	There is no dog barking at a ball	0
A woman is eating a cupcake	A woman is not eating a cupcake	0
A man is playing keyboards	A man is not playing keyboards	0
A man is cutting a boot with a sword	A man is cutting a boot with a blade	1
A person is severing the toe of an empty leather boot with a sword	A man is severing the toe of an empty leather boot with a sword	1
A person is severing the toe of an empty leather boot with a sword	A man is cutting a boot with a sword	1
A woman is severing the toe of an empty leather boot with a sword	A man is cutting a boot with a sword	1
A man is severing the toe of an empty leather boot with a sword	A man is cutting a boot with a blade	1
A man is severing the toe of an empty leather boot with a sword	A man is cutting a boot with a sword	1
A chef is cleaning a bowl of soup	A bowl of soup is being cleaned by a chef	1
A man is wiping the edge of a bowl	There is no man wiping the edge of a bowl	0
The guitar is being played by a kid	A kid is playing the guitar	1
A kid is singing and playing a guitar	A kid is playing the guitar	1
A young boy is singing and playing a guitar	A kid is playing the guitar	1
Someone is stirring a pot of chili with a spoon	A pot of chili is being stirred by someone with a spoon	1
Nobody is stirring a pot of chili with a spoon	Someone is stirring a pot of chili with a spoon	0
Someone is not stirring chili in a kettle	Someone is stirring chili in a kettle	0
Someone is stirring a pot of chili with a spoon	Someone is stirring chili in a pot	1
A man is making a bed	A person is making a bed	1
A small dog is lying on the bed	A small animal is lying on the bed	1
A small dog is lying on a bed	A small dog is lying on the bed	1
A woman is cutting butter	A woman is slicing butter	1
Tofu is being sliced by a woman	A woman is slicing tofu	1
The man is playing the guitar	The man is playing the instrument	1
Some cheese is being put on a pizza by a man	A man is putting some cheese on a pizza	1
There is no man putting some cheese on a pizza	A man is putting some cheese on a pizza	0
There is no man sprinkling cheese on the pizza	A man is putting some cheese on a pizza	0
A man is firing a shotgun	There is no man shooting a shotgun	0
A famous singer is dancing on the ceiling	A person is dancing on the ceiling	1
Hay is being eaten by a cow	A cow is eating hay	1
A cow is eating grass	A cow is not eating hay	1
A man is having lunch	A man is eating	1
A baby is playing with a doll	A baby is playing with a toy	1
A baby is not playing with a doll	A baby is playing with a doll	0
A baby tiger is playing with a ball	There is no baby tiger playing with a ball	0
The man is playing a game on a lawn	The man is playing a game on the grass	1
The man is playing a game on the grass	There is no man playing a game on the grass	0
The rhino is grazing on the grass	The animal is grazing on the grass	1
The rhino is grazing on the grass	There is no rhino grazing on the grass	0
A woman is talking to a man	A man is talking to a woman	1
A woman is cracking eggs	A woman is breaking eggs	1
A bicycle is being ridden by a man	A man is riding a bicycle	1
A man is riding an electric bicycle	A person is riding an electric bicycle	1
A man is riding an electric bicycle	There is no man riding an electric bicycle	0
A man is riding an electric bicycle	A bicycle is being ridden by a man	1
A man is riding an electric bicycle	A man is not riding a bicycle	0
A cat is jumping into a container	A cat is jumping into a box	1
A boy is talking to a leaf	A young man is talking to a leaf	1
A fish is being cut by a man	A man is cutting a fish	1
A man is cutting a fish	A fish is being sliced by a man	1
A man is slicing a fish	A fish is being cut by a man	1
A person is frying some food	A person is cooking some food	1
A woman is cutting a tomato	A woman is slicing a tomato	1
A guitar is being played by a girl	A girl is playing a guitar	1
A man is diving off a cliff	There is no man diving off a cliff	0
A man is riding a motorcycle	A motorcycle is being ridden by a man	1
The man is playing the guitar	The man is playing the instrument	1
There is no man playing the guitar	The man is playing the guitar	0
The man is playing the guitar	The person is playing the guitar	1
The man is playing the guitar	There is no man playing the guitar	0
The man is playing the guitar	The man is playing the instrument	1
A woman is boiling noodles in water	Noodles are being boiled in water by a woman	1
Someone is stirring noodles in the water	Someone is stirring food in the water	1
A woman is boiling noodles in water	Someone is stirring food in the water	1
The women are singing and dancing	The persons are singing and dancing	1
The women are not singing and dancing	The women are singing and dancing	0
Two women are dancing and singing in front of many people	The women are singing and dancing	1
A lemur is biting a person's finger	An animal is biting someone's finger	1
An animal is biting a person's finger	An animal is biting someone's finger	1
A skateboarder is doing acrobatics on a half pipe	A man is skateboarding on a half pipe	1
A skateboarder is doing tricks on a half pipe	A man is skateboarding on a half pipe	1
A big dog is running on the ground	A dog is running on the ground	1
A man and a woman are driving down the street in a jeep	Two persons are driving down the street in a jeep	1
A man and a woman are driving down the street in a jeep	A man and a woman are not driving down the street in a jeep	0
A man and a woman are driving down the street in a jeep	A man and a woman are driving down the road in a car	1
Ingredients are being poured into a bowl by a woman	A woman is pouring ingredients into a bowl	1
There is no woman pouring ingredients into a bowl	A woman is pouring ingredients into a bowl	0
A man is putting vegetables into a pot	Someone is adding ingredients to a pot	1
Nobody is pouring ingredients into a pot	A man is putting vegetables into a pot	0
The man is standing on a rocky mountain and gray clouds are in the background	The man is standing on a mountain, which is rocky, and gray clouds are in the background	1
A person with a back pack, who is topless, is in front of a pile of rocks and clouds are in the background	A topless person with a back pack is in front of a pile of rocks and clouds are in the background	1
The dog is catching a ball	A dog is catching a ball	1
A dog is chasing a ball through dirt	A dog is catching a ball	1
A child, who has blond hair, is holding a yellow bottle	A blond child is holding a yellow bottle	1
A blond child is holding a yellow bottle	There is no blond child holding a yellow bottle	0
The man in a hat suited for cowboys is walking through a market and is putting a hand in his pocket	The man in a cowboy hat is walking through a market and is putting a hand in his pocket	1
The man in a cowboy hat is walking through a market and is putting a hand in his pocket	The man in a cowboy hat is not walking through a market and is not putting a hand in his pocket	0
The man in a hat suited for cowboys is walking through a market and is putting a hand in his pocket	A man in a hat is walking through a store	1
A large white crane is flying near the water	A crane, which is large and white, is flying near the water	1
A dog with golden fur is in the water	A dog with a golden coat is in the water	1
The girl is carrying a sign and a group of people is following her	The girl is carrying a sign and is being followed by a group of people	1
The girl is carrying a sign and a group of people is following her	The girl is not carrying a sign and no group of people is following her	0
One man in a big city is holding up a sign and begging for money	A man in a big city is holding a sign and begging for money	1
A homeless man is holding up a sign and is begging for money	A homeless man is holding up a sign and is pitifully begging for money	1
A dog is chasing the tail of an animal in the grass	The tail of an animal is being chasing by a dog in the grass	1
The small child is wading through the water and is being guided by another person	The small child is not wading through the water and is not being guided by another person	0
A young child is splashing in the water	There is no young child splashing in the water	0
A woman is looking curiously at a man	A man is being curiously looked at by a woman	1
The little dog is grabbing the bedroom slipper with its mouth funnily	The little dog is grabbing the bedroom slipper with its mouth	1
A brown dog is looking closely at a brown and white dog	A brown dog is staring attentively at a brown and white dog	1
A person in a blue jacket is jumping off of a tall cement wall	A person in a blue colored jacket is jumping off of a tall cement wall	1
A person wearing jeans is sitting on top of a horse saddle	There is no person wearing jeans sitting on top of a horse saddle	0
The woman in jeans is sitting on the saddle of a horse	A person wearing jeans is sitting on top of a horse saddle	1
A woman in jeans is sitting on the saddle of a horse	A person wearing jeans is sitting on top of a horse saddle	1
The brown dog and the red dog are frolicking on the beach	A brown dog and a red dog are frolicking on the beach	1
The brown dogs are playfully fighting on the sandy beach	The brown dogs are playfully fighting on the sandy shore	1
The brown dogs are playfully fighting on the sandy beach	The brown dogs are not playfully fighting on the sandy beach	0
The man is standing steadily next to a birdcage	The man is standing next to a bird cage	1
There is no man standing beside a large and colorful birdcage	A man is standing beside a large and colorful birdcage	0
A man is standing beside a birdcage which is large and colorful	The man is standing next to a bird cage	1
One brown and black dog is running through the leaves	A brown and black dog is running through the leaves	1
A dog in a colored coat is running swiftly across the yard	A dog in a colored coat is running across the yard	1
There is no dog in a colored coat running across the yard	A dog in a colored coat is running across the yard	0
A boy wearing red shorts is jumping into a paddling pool	A kid wearing red shorts is jumping into a paddling pool	1
A group of racing dogs is wearing striped uniforms and is running down a track	A group of dogs bred for racing is wearing striped uniforms and is running down a track	1
A group of racing dogs is wearing striped uniforms and is running down a track	There is no group of racing dogs wearing striped uniforms and running down a track	0
Two people are standing in the ocean and watching the sunset	Two people are standing in the ocean and looking at the sunset	1
Two people are standing in the ocean and looking at the sunset	Two people are wading through the water	1
A race car driver is standing up and is fiercely pointing his hand at the sky	A race car driver is standing up and pointing his hand at the sky	1
The person in the blue jacket is wearing a colorful helmet	A person in a blue jacket is wearing a colorful helmet	1
A boy and a girl in swimsuits are wearing arm floats	A boy and a girl in swimsuits are wearing floats for their arms	1
The boy and the girl are playing and wearing arm floats	The boy and the girl are not playing and wearing arm floats	0
A woman in a yellow dyed shirt is surfing on a pink surfboard	A woman in a yellow shirt is surfing on a pink surfboard	1
A woman in a yellow shirt is surfing on a pink surfboard	There is no woman in a yellow shirt surfing on a pink surfboard	0
A surfer is falling off the wave	A surfer is riding the wave	0
A woman in a yellow dyed shirt is surfing on a pink surfboard	A surfer is riding the wave	1
Four people are sitting on a low cement ledge	Some people are sitting on a low cement ledge	1
The group of people is sitting on a ledge which is rocky and a scenic view is behind them	The group of people is sitting on a rocky ledge and a scenic view is behind them	1
The group of people is sitting on a rocky ledge and a scenic view is behind them	The group of people is not sitting on a rocky ledge with a scenic view behind them	0
Two girls are laughing and other girls are watching them	There is no girl laughing and there is no other girl watching	0
A group of Asian girls are standing together	The group of Asian girls are standing together	1
A group of Asian girls are standing by themselves	A group of Asian girls are standing together	1
A bicyclist is holding a bike over his head in a group of people	A lone bicyclist is putting down a bike	0
A cold cyclist is celebrating	There is no cold cyclist celebrating	0
A man is sitting peacefully on a boat in front of the sunset near a flag	A man is sitting on a boat in font of the sunset, near a flag	1
A man is on a ship in front of the sunset	A man is on a boat in front of the sunset	1
There is no man on a boat in front of the sunset	A man is on a boat in front of the sunset	0
A man is sitting peacefully on a boat in front of the sunset near a flag	A man is on a boat in front of the sunset	1
The crowd is not watching two racing cars that are leaving the starting line	The crowd is watching two racing cars that are leaving the starting line	0
A big dog and a small white dog are playing together	A big dog and a small dog with a white coat are playing together	1
A dog, which is brown, is jumping in the air	A brown dog is jumping in the air	1
A malnourished looking dog is standing on its hind legs and preparing to jump	The malnourished looking dog is standing on its hind legs and is preparing to jump	1
The cop is sitting on a police bike	The cop is sitting on a police bicycle	1
The cop is not sitting on a police bike	The cop is sitting on a police bike	0
A policeman is sitting tiredly on a motorcycle	A policeman is sitting on a motorcycle	1
A policeman is sitting tiredly on a motorcycle	The cop is sitting on a police bike	1
A policeman is sitting on a motorcycle	The cop is sitting on a police bike	1
Two women are wearing bikinis on the sandy beach	Two women are wearing bikinis on the beach which is sandy	1
Two women are wearing bikinis and are walking on the sand	There are no women wearing bikinis on the sandy beach	0
Two women are wearing bikinis and are walking on the sand	Two women are wearing bikinis on the sandy beach	1
A black dog is sitting in the grass and keeping its mouth closed	A black dog is running in the grass and its tongue is hanging out	0
A black dog is hanging out in the grass and running with its tongue out	A black dog is running in the grass	1
The cheerleaders are parading and wearing uniforms which are black, pink and white	The cheerleaders are parading and wearing black, pink and white uniforms	1
A large group of cheerleaders is walking in a parade	Many cheerleaders are walking in a parade	1
A large group of cheerleaders is walking in a parade	There is no large group of cheerleaders walking in a parade	0
The man is sitting outside under a purple umbrella	The man is sitting outdoors under a purple umbrella	1
A shoeless woman is sitting on a blanket under a lavender umbrella	A woman, who is shoeless, is sitting on a blanket under a lavender umbrella	1
The woman is playing with two young boys at a park	A woman is playing with two young boys at a park	1
A woman is playing with two young boys at a park	There is no woman playing with two young boys at a park	0
A lady is standing near three children	A woman is standing near three children	1
A woman is standing near three children	There is no woman standing near three children	0
A yellow dog is stopping on white snow on a sunny day	A yellow dog is running on white snow on a sunny day	0
A tan dog is running through the snow	A dog, which is tan, is running through the snow	1
A yellow dog is running on white snow on a sunny day	A dog, which is tan, is running through the snow	1
The little girl in a pink shirt is running under a tree in the desert	A little girl in a pink shirt is running under a tree in the desert	1
The white dog wearing reindeer ears is close to a brown dog	The white dog wearing reindeer ears is near a brown dog	1
The white dog wearing reindeer ears is near a brown dog	The white dog is not wearing reindeer ears and isn't near a brown dog	0
A white dog is wearing a Christmas reindeer headband and is playing with a brown dog in the grass	A white dog is wearing a Christmas reindeer headband and is playing with a dog with a brown coat in the grass	1
A white dog is wearing a Christmas reindeer headband and is playing with a brown dog in the grass	The white dog wearing reindeer ears is near a brown dog	1
A child, who is young, is riding a bike on a rough dirt path	A young child is riding a bike on a rough dirt path	1
The young boy is riding a dirt bike through the mud	A young boy is riding a dirt bike through the mud	1
A young boy is riding a dirt bike through the mud	There is no young boy riding a dirt bike through the mud	0
The woman in a red costume is leaning against a wall made of bricks and playing an instrument	The woman in a red costume is leaning against a brick wall and playing an instrument	1
The woman in a red costume is leaning against a wall made of bricks and playing an instrument	A woman in a red dress is playing an instrument	1
A young child is wearing a white coat and playing a game	A child, who is young, is wearing a white coat and playing a game	1
The child is playing with toys outdoors	There is no young child wearing a white coat and playing a game	0
The man is wearing a wetsuit and is riding a surfboard	The person is wearing a wetsuit and is riding a surfboard	1
A surfer is leaning on a surfboard	The surfer is leaning on a surfboard	1
A waterfall is flowing calmly into a shallow pool	A waterfall is flowing into a shallow pool	1
A dog is herding a group of white sheep on a dusty farm	A dog is herding a pack of white sheep on a dusty farm	1
A sheepdog is grouping a herd of sheep	The sheepdog is grouping a herd of sheep	1
The male, who is dark skinned, is standing on one hand in front of a yellow building	The dark skinned male is standing on one hand in front of a yellow building	1
The dark skinned male is standing on one hand in front of a yellow building	The dark skinned male is not standing on one hand in front of a yellow building	0
A black man is skillfully break dancing on the pavement	A black man is break dancing on the pavement	1
A person who rides bikes, in a black and red uniform, is standing on a dirt bike	A bike rider in a black and red uniform is standing on a dirt bike	1
A man in a purple suit is standing by a purple case and is playing a guitar	A man in a purple colored suit is standing by a purple case and is playing a guitar	1
The man is playing the guitar and has the guitar case open for donations	The man is putting away the guitar in the guitar case	0
A small boy in a yellow shirt is laughing on the beach	There is no small boy in a yellow shirt laughing on the beach	0
The little boy is wearing a yellow tank top and is laughing	A little boy is wearing a yellow tank top and is laughing	1
A small boy in a shirt, which is yellow, is laughing on the beach	A little boy is wearing a yellow tank top and is laughing	1
The orange rescue boat is not rushing across the water	The orange rescue boat is rushing across the water	0
A dog with really long hair and a red vest is running in the grass	A dog with long hair and a red vest is running in the grass	1
The dog in the dyed red vest is running in the field	The dog in the red vest is running in the field	1
The dog in the red vest is not running in the field	The dog in the red vest is running in the field	0
A person is standing in a vast field of glacial ice	One person is standing in a vast field of glacial ice	1
A person is standing in a vast field of glacial ice	There is no person standing in a vast field of glacial ice	0
The person is not standing on white ice	The person is standing on white ice	0
A woman is swiftly snowboarding down an incline and another woman is standing behind her	A woman is snowboarding down an incline and another woman is standing behind her	1
A woman is snowboarding down an incline and another woman is standing behind her	There is no woman snowboarding down an incline and there is no other woman standing behind her	0
The man is taking a picture of himself and another guy	A picture of himself and another guy is being taken by the man	1
The man is not taking a picture of himself and another guy	The man is taking a picture of himself and another guy	0
A man is holding up an electronic device	A person is holding up an electronic device	1
The man is taking a picture of himself and another guy	A person is holding up an electronic device	1
A little black dog is chasing a little brown dog	A dog, which is little and black, is chasing a little brown dog	1
The brown dog and the black dog are in the grass	A brown dog and a black dog are in the grass	1
Women are not wearing bunny ears and race numbers and are not pointing at something in the distance	Women are wearing bunny ears and race numbers and are pointing at something in the distance	0
Several women are wearing pink bunny ears and are pointing to the right	Women are not wearing bunny ears and race numbers and are not pointing at something in the distance	0
The ice hockey goalkeeper is wearing a yellow jersey and is defending the goal	The ice hockey goalkeeper is not wearing a yellow jersey and is not defending the goal	0
The goal is being guarded by a hockey player in a yellow jersey	The ice hockey goalkeeper is wearing a yellow jersey and is defending the goal	1
The ice hockey goalkeeper is wearing a yellow jersey and is defending the goal	A hockey player in a yellow jersey is guarding the goal	1
A child, who looks young, is standing in front of some trees	A young child is standing in front of some trees	1
The small boy is standing in the forest	A small boy is standing in the forest	1
The small boy is standing in the forest	A young child is standing in front of some trees	1
Two people are looking at a statue made of gold	Two people are looking at a gold statue	1
Two young men are cheerfully playing outside near a golden statue	Two young men are playing outside near a golden statue	1
The bicyclist is riding on a city street	The bicyclist is not riding on a city street	0
The woman is wearing a blue helmet and is riding a bicycle in a parking lot	A woman is wearing a blue helmet and is riding a bicycle in a parking lot	1
A woman is wearing a blue helmet and is riding a bicycle in a parking lot	There is no woman wearing a blue helmet and riding a bicycle in a parking lot	0
A pet dog is standing on the bank and is looking at another dog, which is brown, in the pond	A pet dog is standing on the bank and is looking at another brown dog in the pond	1
A pet dog is standing on the bank and is looking at another brown dog in the pond	There is no pet dog standing on the bank and looking at another brown dog in the pond	0
The tan dog is watching a brown dog that is swimming in a pond	The tan dog is not watching a brown dog that is swimming in a pond	0
A young female is dancing	A young girl is dancing	1
A bee is clinging to a yellow flower	A yellow flower is being clung to by a bee	1
The small bee is landing on a bunch of yellow flowers	A small bee is landing on a bunch of yellow flowers	1
Nobody is treading through the snow of the beautiful snowy landscape	Some people are treading through the snow of the beautiful snowy landscape	0
Four people are difficultly walking with difficulty across thick snow and the sun is setting	Four people are walking across thick snow and the sun is setting	1
Four boys are kneeling next to each other in front of a ball	There are no boys kneeling next to each other in front of a ball	0
A tan dog is running through the brush	A dog, which is tan, is running through the brush	1
A hurdle is being leapt by a horse that has a rider on its back	A horse is leaping a hurdle and has a rider on its back	1
Some football players in red and white are jumping and hugging	Football players in red and white are jumping and hugging each other	1
A group of students in uniforms is listening attentively at the front of the class	Some students in uniforms are listening attentively at the front of the class	1
A group of students in uniforms is listening attentively at the front of the class	A group of students in uniforms is ignoring the front of the class	0
A classroom full of students is looking in the same direction inside a bamboo structure	A classroom full of students is looking attentively in the same direction inside a bamboo structure	1
A boy is jumping off a platform and two other boys are standing and watching	A boy is jumping off a platform and two other boys are standing and staring at him	1
A boy is jumping off a platform and two other boys are standing and watching	Nobody is jumping off a platform	0
A group of kids is playing on a structure which is colorful	A group of kids is playing on a colorful structure	1
Four middle eastern children, three girls and one boy, are climbing on the grotto with a pink interior	A group of kids is playing on a colorful structure	1
A group of people is sitting relaxed on both sides of a red stone monument	A group of people is sitting on both sides of a red stone structure	1
The group of people is sitting on the ground outside a monument	Some people are sitting on the ground outside a monument	1
The black bird is sitting comfortably in a leafless tree	The black bird is sitting in a leafless tree	1
The black bird is not sitting in a leafless tree	The black bird is sitting in a leafless tree	0
A black bird is taking flight from a dead tree	The black bird is sitting in a leafless tree	0
A child in orange is playing outdoors with a snowball	A kid in orange is playing outside with a snowball	1
A child is making a snow ball	A child in orange is playing outdoors with a snowball	1
The people are sitting aimlessly on a bench in front of a restaurant	The people are sitting on a bench in front of a restaurant	1
Two people are sitting in lawn chairs and are reading books	Some people are sitting in lawn chairs and are reading books	1
There is no one sitting in lawn chairs and reading books	Two people are sitting in lawn chairs and are reading books	0
Two people in two chairs are reading pleasantly	Two people in two chairs are reading	1
The back of a small black dog is being sniffed by the brown dog	The brown dog is sniffing the back of a small black dog	1
A large brown dog and a small grey dog are standing on a rocky surface	There is no large brown dog and small grey dog standing on a rocky surface	0
The men in brown shorts are walking on the rocks beside a river	The man in brown colored shorts is walking on the rocks beside a river	1
There is no dog jumping for a Frisbee in the snow	A dog is jumping for a Frisbee in the snow	0
The player in purple, white and black is playing near the end of the field	The player in purple, white and black is not playing near the end of the field	0
A man is wearing a sports uniform and is running down the field	A sports uniform is being worn by a man who is running down the field	1
A man on a bicycle is riding on the beach	A man on a bike is riding on the shore	1
There is no man on a bicycle riding on the beach	A man on a bicycle is riding on the beach	0
One person is riding a bicycle in the sand beside the ocean	A person is riding a bicycle in the sand beside the ocean	1
There is no man on a bicycle riding on the beach	A person is riding a bicycle in the sand beside the ocean	1
A seabird is slowly flying over some rocks	A seabird is flying over some rocks	1
There is no seabird flying over some rocks	A seabird is flying over some rocks	0
The kids are chasing each other in the sand	The kids are not chasing each other in the sand	0
A little boy is running on the ground and playing with a little girl	The little boy is running on the ground and playing with a little girl	1
A daughter is being pushed by her father on a go-kart and another girl is watching	A father is pushing his daughter on a go-kart and another girl is watching	1
There is no dog running up a grassy hill	A dog is running up a grassy hill	0
A brown dog is running through the grass which is tall and green	A brown dog is running through tall green grass	1
A brown dog is running through the grass which is tall and green	A golden dog is running through a field of tall grass	1
Two dogs are cheerfully playing on the beach	Two dogs are playing on the beach	1
The large brown dog is running outdoors in the dirt	The large brown dog is running outside in the dirt	1
The large brown dog is not running outside in the dirt	The large brown dog is running outside in the dirt	0
A girl is jumping off a rock and another is standing on it	One girl is jumping off a rock and another is standing on it	1
The man with brown hair is wearing sunglasses and is sitting listlessly at a table with cans of soda and other drinks	The man with brown hair is wearing sunglasses and is sitting at a table with cans of soda and other drinks	1
A young man with brown hair and shades is sitting in front of some cans of soda	A young man with brown hair and sunglasses is sitting in front of some cans of soda	1
There is no young man with brown hair and sunglasses sitting in front of some cans of soda	The man with brown hair is wearing sunglasses and is sitting at a table with cans of soda and other drinks	0
The man with brown hair is wearing sunglasses and is sitting listlessly at a table with cans of soda and other drinks	A young man with brown hair and sunglasses is sitting in front of some cans of soda	1
A bearded man is standing by a shopping cart and is holding a cardboard sign	One bearded man is standing by a shopping cart and is holding a cardboard sign	1
There is no snowboarder doing a flip over a mound of snow	A snowboarder is doing a flip over a mound of snow	0
A girl, who is little, with blond hair is smiling and sitting on a swing	A little girl with blond hair is smiling and sitting on a swing	1
There is no little girl with blond hair smiling and sitting on a swing	A little girl with blond hair is smiling and sitting on a swing	0
A blond kid in green is sitting on a swing	A blonde boy in green is sitting on a swing	1
Music is being performed by four people outdoors	Four people are performing music outdoors	1
A man is participating in a bmx race	A man is participating in a race for bmxs	1
A man is participating in a bmx race	A man is not participating in a bmx race	0
A man in a red uniform is swiftly making a jump in a dirt bike race	A man in a red uniform is making a jump in a dirt bike race	1
A happy family is posing by the fireplace	A family, which looks happy, is posing by the fireplace	1
The family is posing by a mantel and a Christmas tree	A family is posing by the mantel and the Christmas tree	1
There is no family posing by the mantel and the Christmas tree	A family is posing by the mantel and the Christmas tree	0
An opponent is tackling a soccer player	A soccer player is being tackled by his opponent	1
There is no soccer player who is being tackled by an opponent	A soccer player is being tackled by his opponent	0
Rugby players are not tackling each other	Rugby players are tackling each other	0
A dog, which is white, is standing on fallen leaves	A white dog is standing on fallen leaves	1
A white dog is standing on the leaves on the ground	One white dog is standing on the leaves on the ground	1
There is no white dog standing on the leaves on the ground	A white dog is standing on the leaves on the ground	0
Two girls are not playing inside the jumper house	Two girls are playing inside a jumper house	0
The boy and girl are playing on the outdoor gym	A boy and a girl are playing on the outdoor gym	1
Some children are playing on a playground	Some kids are playing on a playground	1
The motocross rider is wearing blue and black pants	Blue and black pants are being worn by the motocross rider	1
A man is drinking orange juice and walking on a sunny day	There is no man drinking orange juice and walking on a sunny day	0
There is no man drinking orange juice and walking on a sunny day	A man is drinking orange juice and walking	0
A man is drinking orange juice and walking on a sunny day	A person is drinking orange juice and walking	1
A man is drinking orange juice and walking on a sunny day	A man is drinking orange juice and walking	1
A man on inline skates is skating at a skate park	A man on inline skates is skating at a park built for skating	1
The crowd is watching a football game	A football game is being watched by the crowd	1
The crowd is watching a football game	The crowd is not watching a football game	0
The crowd is watching the football at the game	The crowd is watching a football game	1
A group of people playing football is running in the field	A group of football players is running in the field	1
A group of people is standing together and looking at the camera	There is no group of people standing together and looking at the camera	0
An oriental man and two women are facing a camera	The group of people is standing together and looking at the camera	1
An oriental man and two women are facing a camera	There is no group of people standing together and looking at the camera	0
An oriental man and two women are facing a camera	A group of people is standing together and looking at the camera	1
A child is sitting in a red and yellow toy car	There is no child sitting in a red and yellow toy car	0
A small girl is riding in a toy car	The small girl is riding in the toy car	1
A small girl is riding in a toy car	A small girl is getting out of a toy car	0
A child in a red outfit is jumping on a trampoline	A little boy in red clothes is jumping into the air	1
A brown dog and a black dog are frolicking in the sand	A brown dog and a black dog are playing in the sand	1
A brown dog and a black dog are playing in the sand	There is no brown dog and black dog playing in the sand	0
A brown dog and a black dog are frolicking in the sand	A black dog is playing with a brown dog on the sand	1
A black dog is playing with a brown dog on the sand	There is no brown dog and black dog playing in the sand	0
A woman and three men are posing motionlessly for a photo	Three men and a woman are posing for a picture	1
There is no young boy covered in grass jumping near a wooden fence	A young boy covered in grass is jumping near a wooden fence	0
A wet boy is cheerfully jumping around on dirty and wet grass	A wet boy is jumping around on dirty and wet grass	1
A black dog is walking through some tall grass	The black dog is walking through the tall grass	1
The black dog is sprinting through the grass	The black dog is running through the grass	1
The black dog is running through the grass	The black dog is not running through the grass	0
The black dog is running through the grass	The black dog is walking through the tall grass	0
A dog is standing with its two front paws on a rock in a field	The dog is standing with its two front paws on a rock in the field	1
A dog is standing with its two front paws on a rock in a field	There is no dog standing with its two front paws on a rock in the field	0
A brown dog is running breathlessly across the yard with a toy in its mouth	A brown dog is running across the yard with a toy in its mouth	1
The person with the green shirt is jumping high over the grass	A person with a green shirt is jumping high over the grass	1
A person with a green shirt is jumping high over the grass	A person without shirt is jumping high over the green grass	0
A young boy is jumping in the air with his knees bent and arms spread	There is no young boy jumping in the air with his knees bent and arms spread	0
A dog is missing the ball in mid air	A dog is catching a ball in mid air	0
A brown and white dog is jumping in the air with a tennis ball in its mouth	A brown and white dog is resting on the ground with a tennis ball in its mouth	0
A brown and white dog is jumping in the air with a tennis ball in its mouth	A dog is caught mid air with a ball	1
A woman is speaking loudly on her cell phone and is keeping a purse and a yellow bag on the near ledge	A woman is speaking on her cell phone and is keeping a purse and a yellow bag on the near ledge	1
There is no brown duck with a green head flapping its wings in the water	A brown duck with a green head is flapping its wings in the water	0
A bird is fiercely flapping its wings on the water	A bird is flapping its wings on the water	1
A brown duck with a green head is flapping its wings in the water	A bird is flapping its wings on the water	1
The brown dog is not playing outdoors	The brown dog is playing outdoors	0
A furry brown dog is running through the grassy area	The furry brown dog is running through the grassy area	1
The elderly lady is not waiting on the sidewalk	The elderly lady is waiting on the sidewalk	0
There is no young child running outside over the fallen leaves	A young child is running outside over the fallen leaves	0
There is no young child running outside over the fallen leaves	A young child is running down a gravel road that is covered with dead leaves	0
The man in the straw hat is smoking a cigarette	A cigarette is being smoked by the man in the straw hat	1
The man in the straw hat is smoking a cigarette	A person is wearing a straw hat and smoking a cigarette	1
A man is wearing a straw hat and smoking a cigarette	The man in the straw hat is smoking a cigarette	1
A man is wearing a blue checkered shirt and cheerfully riding a unicycle in the street	A man is wearing a blue checkered shirt and riding a unicycle in the street	1
A man is wearing a blue checkered shirt and riding a unicycle in the street	There is no man wearing a long sleeved blue shirt and jeans and riding a unicycle down a street	0
Three men are staring at the big green hills in the distance	Three men are looking into the distance	1
A mountain is being climbed by two men	The men are climbing a mountain	1
Two children are playing on a statue	Some children are playing on a statue	1
Two children are playing on a statue	There are no children playing on a statue	0
A blonde lady is looking at a tower	There is no blonde lady looking at a tower	0
A woman is looking at the view of a city	The woman is looking at the view of a city	1
A man is standing on the top of the rocks with clouds behind them	One man is standing on the top of the rocks with clouds behind them	1
A kid is smiling at the camera and swimming underwater	A child is smiling at the camera and swimming underwater	1
A child is playfully swimming underwater in a pool	A child is swimming underwater in a pool	1
A yellow kayak is being ridden by a man and a young boy	A man and a young boy are riding in a yellow kayak	1
An American footballer is wearing the red and white strip	The American footballer is wearing a red and white strip	1
There is no dog chasing a ball in the grass	A dog is chasing a ball in the grass	0
A dog is chasing a ball on the grass	A ball is being chased by a dog on the grass	1
A dog is chasing a ball in the grass	A ball is being chased by a dog on the grass	1
A dog is running after a ball in the grass	A dog is chasing a ball on the grass	1
A dog is chasing a ball on the grass	A dog is chasing a ball in the grass	1
A tan dog is jumping up and catching a tennis ball	There is no tan dog jumping up and catching a tennis ball	0
The little girl is not swinging and the woman is not standing behind her	The little girl is swinging and the woman is standing behind her	0
A man is performing a trick on a surfboard in the water	A person is performing a trick on a surfboard in the water	1
A surfer is riding the wave	The wave is being ridden by a surfer	1
A surfer is riding the wave	A rider is surfing the wave	1
A man and two women in a darkened room are sitting at a table with candles	The group of people is not sitting in a dim room	0
A man and two women in a darkened room are sitting at a table with candles	The group of people is sitting in a dim room	1
Two guys are sitting around a table and holding beers in their hands	Two blokes are sitting around a table and holding beers in their hands	1
The dog is chasing the ball	A dog is chasing a ball	1
A dog is chasing a ball	There is no dog chasing a ball	0
The woman is wearing a red jacket and holding a glass in front of the man in a t-shirt, which is white	The woman is wearing a red jacket and holding a glass in front of the man in a white t-shirt	1
Two brown dogs are playing with a frisbee in the water	Two brown dogs are playing with the frisbee in the water	1
Two dogs are battling for a frisbee in a lake	Two dogs are fighting for a frisbee in a lake	1
There are no dogs fighting for a frisbee in a lake	Two dogs are fighting for a frisbee in a lake	0
A girl in pink is twirling a ribbon	There is no girl in pink twirling a ribbon	0
There is no child playing with a water spout outdoors with the rest of his family watching	A child is playing with a water spout outdoors and the rest of his family is watching	0
A hose is being held by a boy next to a man and another boy is watching	A boy is holding a hose next to a man and another boy is watching	1
A football player in a purple jersey is running with the ball for a touchdown	There is no football player in a purple jersey running with the ball for a touchdown	0
A young girl in blue is jumping in the air	There is no girl in blue jumping in the air	0
A young girl in a blue leotard is jumping in the air	The young girl in blue is jumping in the air	1
A young girl in a blue leotard is jumping in the air	There is no girl in blue jumping in the air	0
A young girl in a blue leotard is jumping in the air	A young girl in blue is jumping in the air	1
A small boy in a striped shirt is sliding out of a green tube	A little boy in a striped shirt is sliding out of a green tube	1
The person is flying through the air on a bicycle	The person is not flying through the air on a bicycle	0
There is no person on a bike jumping through the air with the sun flaring through the bike frame	A person on a bike is jumping through the air and the sun is flaring through the bike frame	0
A person on a bike is jumping through the air and the sun is flaring through the bike frame	The person is flying through the air on the bicycle	1
The bunch of men are playing rugby on a muddy field	The bunch of men are not playing rugby on a muddy field	0
The bunch of men are playing rugby on a muddy field	Rugby is being played by some men	1
The bike rider is not looking at the accident of another bike rider	The bike rider is looking at an accident of another bike rider	0
A person is looking at a bike designed for motocross that is lying on its side and another is racing by	A person is looking at a motocross bike that is lying on its side and another is racing by	1
There are no dogs playing in the snow	A brown dog and a gray dog are playing in the snow	0
A young woman is getting a tattoo on her hand	A girl is getting a tattoo on her hand	1
A tattoo is being drawn by the woman in the white sweater on the hand of a teenager	The woman in the white sweater is drawing a tattoo on the hand of a teenager	1
The woman in the white sweater is not drawing a tattoo on the hand of a teenager	The woman in the white sweater is drawing a tattoo on the hand of a teenager	0
A woman in a purple top is walking a bicycle between two stone columns	There is no woman in a purple top walking a bicycle between two stone columns	0
A girl dressed in purple and blue is slowly walking beside her bike at night	A girl dressed in purple and blue is walking beside her bike at night	1
The black dog is walking along a tree trunk bridge over water	The black dog is not walking along a tree trunk bridge over water	0
A dog is crossing a river on a bridge made from a fallen tree	There is no dog crossing a river on a bridge made from a fallen tree	0
A tree is falling over a bridge made over the river which a dog is crossing	A dog is crossing a river on a bridge made from a fallen tree	1
The black dog is walking along a tree trunk bridge over water	There is no dog crossing a river on a bridge made from a fallen tree	0
The black dog is walking along a tree trunk bridge over water	A tree is falling over a bridge made over the river which a dog is crossing	1
A child in a green and white sports uniform is resting on the grass	A child in a green and white sports uniform is running over the grass	0
A little boy is proudly wearing a green soccer strip and is running on the grass	A little boy is wearing a green soccer strip and is running on the grass	1
A young lady in a bikini is lying on the beach	A lady who looks young is lying on the beach	1
The man is doing a handstand on the wet shore at the edge of the water at the beach	The man is doing a handstand on the wet sand at the edge of the water at the beach	1
A man is performing a handstand on the beach	A handstand is being performed by a man on the beach	1
The man is doing a handstand on the wet sand at the edge of the water at the beach	A handstand is being performed by a man on the beach	1
The man is doing a handstand on the wet shore at the edge of the water at the beach	A man is performing a handstand on the beach	1
A boy of young age is playing in the park with his mother	A young boy is playing in the park with his mother	1
The boy in blue is running away from the woman in blue	A boy in blue is running away from a woman in blue	1
A little boy with brown hair is jumping off of a brown chair onto the floor	There is no little boy with brown hair jumping off of a brown chair onto the floor	0
A young boy is quickly jumping off a chair	A young boy is jumping off a chair	1
A young boy is jumping off a chair	A young boy is jumping onto a chair	0
One little boy with brown hair is jumping off of the brown chair onto the floor	A young boy is jumping off a chair	1
The children are not wearing black tights and are not hopping	The children are wearing black tights and hopping	0
The blonde girl with the pink top is smiling and wearing funny glasses with a large nose attached	The little girl is smiling and wearing a fake nose and glasses	1
The blonde girl with the pink top is smiling and wearing funny glasses with a large nose attached	A little girl is smiling and wearing a fake nose and glasses	1
A man is squirting water into the mouth of a white dog with a squirt gun	There is no man squirting water into the mouth of a white dog with a squirt gun	0
A man is spraying a super soaker into the mouth of a dog	There is no man squirting water into the mouth of a white dog with a squirt gun	0
A boy under an umbrella is being held by his father who is wearing a coat dyed in blue	A boy under an umbrella is being held by his father who is wearing a blue coat	1
A light brown dog is running up a street	The light brown dog is running up a street	1
A great dog is climbing a steep hill	A great dog is wildly climbing a steep hill	1
A man and a woman are walking down the street of a city	A man and a woman are walking down a city street	1
People are walking through a crowded street	People are walking through a street which is crowded	1
A surfer is riding a big wave	The surfer is riding a big wave	1
The surfer is riding a small wave	The surfer is riding a big wave	0
A surfer is riding a big wave across dark green water	A surfer is riding a big wave	1
A surfer is riding a big wave across dark green water	The surfer is riding a big wave	1
The shirtless man in striped shorts and sunglasses is standing near a man in a white shirt and sunglasses	The shirtless man in striped shorts and sunglasses is standing near a person in a white shirt and sunglasses	1
The shirtless man in striped shorts and sunglasses is not standing near a man in a white shirt and sunglasses	The shirtless man in striped shorts and sunglasses is standing near a man in a white shirt and sunglasses	0
The muscular black man is dancing and the man behind him is wearing green beads	The muscular man is dancing and the man behind him is wearing green beads	1
There is no person wearing grey pants who is airborne on a snowboard	A person wearing grey pants is airborne on a snowboard	0
A tennis player with a green headband is hitting the ball	A tennis player with a green headband is missing the ball	0
A man is crouching and holding a camera	A person is crouching and holding a camera	1
A man is squatting in brush and taking a photograph	There is no man squatting in brush and taking a photograph	0
A man is squatting in brush and taking a photo	A man is crouching and holding a camera	1
A man is squatting in brush and taking a photograph	A person is crouching and holding a camera	1
Some dogs are playing in a river	Some dogs are playing in a stream	1
A black dog is jumping from a cylindrical hay bale	A black dog is leaping from a cylindrical hay bale	1
A brown dog is jumping in the air	There is no brown dog jumping in the air	0
There is no brown dog jumping in the air	The brown dog is jumping in the air	0
The brown dog is jumping in the air	A brown dog is jumping in the air	1
Two adults are standing on a scooter in a field of yellow flowers	Two adults are standing on a scooter in a field of flowers	1
Two people wearing helmets are riding over the yellow and white flowers	Two people wearing helmets are driving over the yellow and white flowers	1
There is no person riding a bike along a muddy trail	A person is riding a bike along a muddy trail	0
A man in blue is riding a horse on a dirt road	A man in blue is riding a animal on a dirt road	1
Three people are driving ATVs	ATVs are being driven by three people	1
Three people are driving four wheel ATVs in a field	ATVs are being driven by three people	1
Two white dogs and one brown dog are chasing a ball	Two white dogs and one brown dog are chasing a toy	1
Two white dogs and one brown dog are not chasing a ball	Two white dogs and one brown dog are chasing a ball	0
Two white dogs are playing with a brown dog and a ball	Two white dogs and one brown dog are chasing a toy	1
A white race car is driving through a puddle	A white racing vehicle is driving through a puddle	1
The white rally car is throwing mud into the air and is approaching a bend in the track	A white rally car is throwing mud into the air and is approaching a bend in the track	1
A white rally car is throwing mud into the air and is approaching a bend in the track	A white racing vehicle is driving through a puddle	1
A dog is jumping at a shiny blue soccer ball in a field of dry leaves	There is no dog jumping at a shiny blue soccer ball in a field of dry leaves	0
A dog is not running towards a ball	A dog is running towards a ball	0
A dog is not running towards a ball	A dog is running through a field and is chasing a ball	0
Four athletes are with a man in a crowded stadium	Four athletes are with a person in a crowded stadium	1
A person in a pink jacket is running onto the field	A person in pink is running onto the field	1
A fur scarf is being held by an Asian woman	An Asian woman is holding a fur scarf	1
An Asian woman is holding a fur scarf	There is no Asian woman holding a fur scarf	0
A woman dressed in elegant clothing is inside a crowd of people and is looking down	An elegant woman is inside a crowd of people and is looking down	1
A boy in a white t-shirt is splashing in shallow water	There is no boy in a white t-shirt splashing in shallow water	0
A basketball player is on the court floor and another one is grabbing the ball	A basketball player is on the court floor and the ball is being grabbed by another one	1
There is no basketball player on the court floor and no one is grabbing the ball	Two basketball players are scrambling for the ball on the court	0
A black sheep is standing near three white dogs	A black sheep is standing close to three white dogs	1
Two poodles are in the snow and one is jumping high	Two poodles are in the snow and one is jumping	1
The man surrounded by photographers is wearing a gray suit and glasses	The man surrounded by men with a camera is wearing a gray suit and glasses	1
The man surrounded by photographers is wearing a gray suit and glasses	A man in a suit is not being surrounded by photographers	0
The man surrounded by men with a camera is wearing a gray suit and glasses	A man in a suit is being surrounded by photographers	1
Children in swimming suits are not playing in the water	Children in swimming suits are playing in the water	0
The kids are wearing bathing suits and water is splashing around	The kids are not wearing suits and water is splashing around	0
People are dangling from straps and kicking at each other	Nobody is dangling from straps and kicking at each other	0
A man dressed in black and white is holding up the tennis racket and is waiting for the ball	A player dressed in black and white is holding up the tennis racket and is waiting for the ball	1
A tennis player in mid game is holding a racquet	A racquet is being held by a tennis player in mid game	1
A brown and white dog is playing on the grass	A brown and white dog is playing on the lawn	1
A tan skinned kid is looking at the camera	A tan skinned child is looking at the camera	1
There is no tan skinned child looking at the camera	A tan skinned child is looking at the camera	0
A little boy with a bib is not watching the camera	A little boy with a bib is watching the camera	0
A young boy in the blue shirt is jumping into the water	The young boy in the blue shirt is jumping into the water	1
The young boy in the blue shirt is not jumping into the water	The young boy in the blue shirt is jumping into the water	0
A young boy is diving into a still lake	A young boy is jumping into a still lake	1
A young girl is sitting in a swimsuit	A young girl is sitting in swimming gear	1
A dog is running on a snowy road	A dog is running on a snowy path	1
A brown dog is running through a snowy path	A dog is running on a snowy path	1
A white dog is running through a snowy trail	A dog is running on a snowy path	1
A brown dog is running through a snowy trail	A dog is running on a snowy path	1
Two boys in white outfits and red protective gear are sparring on a mat	Two children in white outfits and red protective gear are sparring on a mat	1
A black and white dog is playing with a broken volleyball	A black and white dog is playing with a broken ball	1
A black and white dog is playing with a tattered volleyball in a brown field	A black and white dog is playing with a broken volleyball	1
A young boy in a helmet is riding a bike on the road	A bike is ridden on the road by a young boy in a helmet 	1
The little boy is riding a bicycle in a race	A bicycle is being ridden by the little boy in a race	1
Two boys and a man are playing games at an arcade	Two kids and a man are playing games at an arcade	1
A family is not purchasing something at a vending machine	A family is purchasing something at the vending machine	0
Some cheerleaders are taking a break	Some cheerleaders are relaxing	1
A group of people is holding drinks and pointing at the camera	Drinks are being held by people pointing at the camera	1
Several young people are posing for a photo and holding beers	Several young people are posing for a photo and holding drinks	1
A girl with red hair and red eyebrows is talking	A girl with red hair and red eyebrows is in midspeech	1
The girl in blue is chasing the base runner with a number on the jersey	The girl in blue is chasing the player with a number on the jersey	1
The young man is not rock climbing	The young man is rock climbing	0
A man in a purple hat is climbing a rocky wall with bare hands	A rocky wall is climbed by a man in a purple hat with bare hands	1
A man in a purple hat isn't climbing a rocky wall with bare hands	A man in a purple hat is climbing a rocky wall with bare hands	0
A rocky wall is climbed by a man in a purple hat with bare hands	The young man is rock climbing	1
A blond woman is sitting on the roof of a yellow vehicle and two people are inside	A woman with blond hair is sitting on the roof of a yellow vehicle and two people are inside	1
A yellow dog is drinking water from the faucet	A yellow dog is not drinking water from the faucet	0
A yellow dog is drinking water from the faucet	The yellow dog is drinking water from a bottle	0
Adults and children standing and playing in front of steps near a wooded area	Adults and children standing and playing in front of a stair near a wooded area	1
The adults and children are being grouped near an outdoor seating arrangement	The adults and children are being gathered near an outdoor seating arrangement	1
A woman is looking down and is wearing a wedding dress	A woman is looking down and is wearing a wedding veil	1
A bride with a black veil is looking down	A woman is looking down and is wearing a wedding veil	1
A girl has black and orange patches on the cheeks	A girl has colored patches on the cheeks	1
There is no girl with black and orange patches on the cheeks	A girl has black and orange patches on the cheeks	0
Two large dogs are frolicking in a grassy field	Two large dogs are frolicking in a field	1
Two dogs are running through high grass	Two animals are running through high grass	1
A black dog is walking along rocky terrain	A black dog is moving along rocky terrain	1
A black dog is running across a rocky landscape	A black dog is moving along rocky terrain	1
Some young dirt bikers are getting a dirt bike up a sandy hill	Some young bikers are getting a dirt bike up a sandy hill	1
Pedestrians and cars are moving through a traffic jam in a big city	Pedestrians and cars are moving through a traffic jam in the big city	1
Some people and vehicles are on a crowded street	Pedestrians and cars are moving through a traffic jam in the big city	1
A man is sitting on the grass and drinking from a water bottle	A man is sitting on the lawn and drinking from a water bottle	1
A dog is running on the sea shore	A dog is running on the beach	1
A chubby faced boy is wearing sunglasses	A chubby faced boy is wearing dark glasses	1
A chubby faced boy is wearing sunglasses	Sunglasses are being worn by a boy	1
A chubby faced boy is wearing sunglasses	A boy is wearing sunglasses	1
Children are being dressed in costumes and playing a game	Kids are being dressed in costumes and playing a game	1
Dogs are racing on a track	Dogs are running on a track	1
Dogs are racing on a track	There is no dog racing on a track	0
Two bmx bikers are jumping dirt ramps in front of the water	Two bmx bikers are jumping dirt ramps in front of a body of water	1
Some bikers are doing acrobatics on a track near water and a skyline	Some bikers are getting airborne on a track near water and a skyline	1
Some bikers are getting airborne on a track near water and a skyline	Some bikers are not getting airborne on a track near water and a skyline	0
Two bmx bikers are jumping dirt ramps in front of the water	Some bikers are getting airborne on a track near water and a skyline	1
A man is doing a skateboard trick on an outdoor park porch	A man is doing a skateboard trick on a park porch	1
A man is doing a skateboard trick on a park porch	A man is doing a trick on a skateboard	1
A man is doing a skateboard trick on an outdoor park porch	A person is doing a trick on a skateboard	1
A man in full gear is wearing a helmet with sponsor logos and is riding a red sport motorcycle	A racer in full gear is wearing a helmet with sponsor logos and is riding a red sport motorcycle	1
A racer in full gear is wearing a helmet with sponsor logos and is riding a red sport motorcycle	A man in a motocross uniform is wearing a helmet and rides a red motorcycle	1
People are sitting at square tables in a red room	People are sitting at tables in a red room	1
A boy is jumping off the side of a water fountain made of stone in front of a building	A boy is jumping off the side of a stone water fountain in front of a building	1
A girl in blue is sliding down a green slide	A girl in blue is sliding down a slide	1
The young girl in blue is having fun on a slide	The young girl in blue is enjoying a slide	1
A black man is walking next to a shop in a big city	A black man is walking next to a building in a big city	1
There is no man playing guitar next to a drummer	A man is playing guitar next to a drummer	0
A black dog is jumping off a dock into a pond	A black dog is jumping off a dock into water	1
A black dog is jumping off a dock into a pond	A black dog is jumping on a dock into a pond	1
A black dog is jumping off a dock into water	A black dog is jumping from a dock into the water	1
A little girl is smiling and running out of the house	A little girl is smiling and running outside	1
A skier in black is catching a tiny bit of air	A skier dressed in black is catching a tiny bit of air	1
A child is playing slip and slide in the grass	A child is not playing slip and slide in the grass	0
A child is splashing in a pool for children and other kids are playing in the background	A child is splashing in a pool for children and other children are playing in the background	1
Two men are looking out and binoculars are being held by one of them	Two men are looking out and one is holding binoculars	1
Two men are standing together and one is looking through binoculars	Two men are looking out and binoculars are being held by one of them	1
A motorcyclist on a bike is leaning into a sharp corner	There is no motorcyclist on a bike leaning into a sharp corner	0
A man on a motorcycle is turning around a corner	A man on a motorcycle is going around a corner	1
A motorcyclist on a bike is leaning into a sharp corner	A man on a motorcycle is turning around a corner	1
A man on a motorcycle is going around a corner	There is no motorcyclist on a bike leaning into a sharp corner	0
A man with a backwards hat is sitting on the ground	A person with a backwards hat is sitting on the ground	1
A young man in a white shirt and gold and black hat is sitting with crossed legs	A young person in a white shirt and gold and black hat is sitting with crossed legs	1
A young oriental girl is standing above the crowd and is playing with a pinwheel	A young oriental girl is standing above people and is playing with a pinwheel	1
A young man on a bmx bicycle is jumping on a masonry pyramid	A young man on a bmx bicycle is jumping off a masonry pyramid	1
There is no bicyclist jumping on a pyramid-shaped ramp	A bicyclist is jumping on a pyramid-shaped ramp	0
A young man on a bmx bicycle is jumping off a pyramid	A bicyclist is jumping on a pyramid-shaped ramp	1
A bicyclist is jumping on a pyramid-shaped ramp	A young man on a bmx bicycle is jumping off a masonry pyramid	1
A man with no shirt is holding a football	A football is being held by a man with no shirt	1
The man is going into the lake	The person is going into the water	1
The man is going into the water	The person is going into the water	1
Five people are standing in the grass with three dogs	Five people are standing in the grass with some dogs	1
Five people are standing with three dogs in the green field beside the road	Five people are standing in the grass with some dogs	1
Five people are standing in the grass with no dogs	Five people are standing with three dogs in the green field beside the road	0
A rainbow afghan is being held by a girl in gold and purple	A girl in gold and purple is holding a rainbow afghan	1
A light brown dog is running in the water	A light brown dog is sprinting in the water	1
The child is splashing water in a small blue pool	The child is splashing water in a pool	1
A baby is splashing inside a blue paddling pool	A toddler is making a splash inside a blue paddling pool	1
A grey silky dog is running in the grass and a brown dog looks on	A grey silky dog is lying in the grass and a brown dog is looking on	0
A man in a hat is standing outside of a green jeep	A man in a hat is standing outside of a green vehicle	1
A man in a hat is standing outside of a green jeep	A man with no hat is standing outside of a green jeep	0
A large dog and a small dog are standing next to the kitchen counter and are investigating	A large dog and a small dog is standing on the kitchen counter and investigate	1
A tan dog which is dirty is rolling in the dirt and looking right at the camera	A dog is rolling on the ground	1
An Arabic man is wearing a white hat	A white hat is being worn by an Arabic man	1
A man with a white hat and brown shirt is behind a woman in red and is looking to the left	A man with a white hat and brown shirt is behind a woman in red and is looking to the side	1
Children are playing in a fountain that is spraying water from the ground	Children are playing in ground fountains	1
A person on a yellow bike is airborne	A cyclist on a yellow bike is airborne	1
A cyclist on a yellow bike is airborne	There is no cyclist on a yellow bike airborne	0
A person on a yellow bike is airborne	A person on a yellow dirt bike is taking a jump	1
There is no cyclist on a yellow bike airborne	A person on a yellow dirt bike is taking a jump	0
A man on a yellow dirt bike is taking a jump	A cyclist on a yellow bike is airborne	1
A person on a yellow clean bike is taking a jump	A cyclist on a yellow bike is airborne	1
The bicycle is being ridden by a man wearing a beret on a recreation trail	A man is wearing a beret and is riding the bicycle on a recreation trail	1
Five adults are sitting on stone steps	Five adults are sitting on steps made of stone	1
People are sitting against a wall	People are sitting near a wall	1
A man is rock climbing and a city and a bay are in the background	A person is rock climbing and a city and a bay are in the background	1
People are grouping at a stand at the fair	A group of people is gathering at a stand at the fair	1
Rollerbladers are rolling in formation down a hill	Rollerbladers are not rolling in formation down a hill	0
A woman is marching with a pair of dogs	A woman is walking with a pair of dogs	1
A skateboarder is making a jump off a ramp	No skateboarder is making a jump off a ramp	0
A man dressed in black is wearing inline skates and performing acrobatics on a rail	A man dressed in black is wearing inline skates and performing a trick on a rail	1
Three children are running down a grassy hillside	Three children are running down a hillside covered by grass	1
Three children are running down a hillside covered by grass	Three children are running down hill	1
A black and orange bird is standing on the lawn	A black and orange bird is standing in the grass	1
A black and orange bird is standing in the grass	A black and orange bird is not standing in the grass	0
A shirtless man is posing with a girl who is hiking in a park	A shirtless person is posing with a girl who is hiking in a park	1
A shirtless man is posing with a girl who is hiking in a park	A man without a shirt is posing with the arms spread near a woman	1
Two white puppies are playing near a pool	Two white puppies are playing near water	1
A group of people are not standing around a sound mixing table	A group of people are standing around a sound mixing table	0
A young couple is lying on a bed together	A young couple is not lying in bed	0
Three men are walking across a rope and wood bridge over a river	Three people are walking across a rope and wood bridge over a river	1
People are crossing a rope bridge over a rocky stream	People are walking across a rope bridge over a rocky stream	1
Three people are walking across a rope and steel bridge over a river	People are walking across a rope bridge over a rocky stream	1
Four people are walking on a bridge over a river	Four people are walking on a bridge over a body of water	1
Several people are walking in line across a bridge	Several people are not walking in line across a bridge	0
A young boy is jumping into water	A young kid is jumping into water	1
A young boy is jumping out of the water	A young boy is jumping into water	0
The young child is riding a three wheeled scooter down the sidewalk	A young child is riding a three wheeled scooter down the sidewalk	1
Three men are sitting on a mountainside and looking at the view with a pair of binoculars	Three hikers are sitting on a mountainside and looking at the view with a pair of binoculars	1
A young girl is jumping rope on a sidewalk near a parking garage	A girl is skipping rope on a sidewalk	1
A girl is jumping rope on a sidewalk near a parking garage	A girl is skipping rope on a sidewalk	1
No people is sitting around a fire at night	People are clustered around a bonfire at night	0
People are sitting around a bonfire at night	Several people are sitting around a fire at night	1
Two dogs are running through the park	Two animals are running through the park	1
Two dogs are running quickly through the park	Two dogs are running quickly through a park	1
A boy is speeding down a steep slide	A kid is speeding down a steep slide	1
A brown and white dog with a brown and black bandanna is quickly running 	A brown and white dog with a brown and black bandanna is running very fast	1
A black dog on a leash is walking in the water	The dog is on a leash and is walking in the water	1
A red sled is being held by a little girl in a green coat and a boy walking in the snow	A little girl in a green coat and a boy holding a red sled are walking in the snow	1
Two people are riding motorbikes	Motorbikes are being ridden by two people	1
A man is leaning against a pole and is surrounded by people	A man is leaning against a pole and is surrounded	1
A middle eastern man is standing against a lamp post near to other people	A man is leaning against a pole and is surrounded by people	1
A man and a woman are sitting in front of an art gallery and are looking at a map	A couple is looking at a map	1
A couple is looking at a street guide	A man and a woman are standing in front of an art gallery and are looking at a map	1
A little dog is running on the sand	No little dog is running on the sand	0
Two males are standing on a cliff edge and one is jumping into the sea	Two males are standing on a cliff edge and one is jumping into the water	1
One boy in orange shorts is standing on a rock cliff over the water and the other boy in black shorts is jumping of it into the water	Two males are standing on a cliff edge and one is jumping into the sea	1
One boy in orange shorts is standing on a rock cliff over the water and the other boy in black shorts is diving into the water	Two males are standing on a cliff edge and one is jumping into the water	1
A boy in blue shirt is looking at his hand near a stack of blocks on table	The boy in blue shirt is looking at his hand near the stack of blocks on table	1
A woman in a bikini is pulling a dog on a leash at the seashore	A woman in a bikini is pulling a dog on a leash at the beach	1
A small group of people are standing and two are sitting on the couch	A small group of people are standing and two are sitting on the sofa	1
A group of five young adults are lounging in the room	A group of five young adults are lounging indoors	1
The dog has its head inside a red and green gift bag	A dog has its head inside a red and green gift bag	1
A cyclist is biking in a snowy forest in the dark	A cyclist is biking in a snowy forest at night	1
A cyclist is biking in a snowy forest at day	A cyclist is biking in a snowy forest at night	0
A white hat is being worn by a boy which is running on the beach	A boy is wearing a white hat and is running on the beach	1
A man in a black hat is reaching for a box	A person in a black hat is reaching for a box	1
A young girl with a heart tank top is raising her hands as she is playing on a slide	A young girl with a heart tank top is raising her hands as she is sliding	1
A brown dog is running after a black dog on a rocky shore	A brown dog is running after a dark dog on a rocky shore	1
Two dogs are playing on a rocky beach	Two dogs are playing on a beach made of rocks	1
A black dog is approaching a golden dog on pebbly beach	A black animal is approaching a golden dog on pebbly beach	1
A large white dog is jumping in the air over an area covered by snow	A large white dog is jumping in the air over a snowy area	1
A large white dog is jumping in the air over a snowy area	A large white animal is jumping up in the snow	1
A large white dog is jumping in the air over an area covered by snow	A large white dog is jumping up in the snow	1
A pair of kids are sticking out blue and green colored tongues	Two kids are sticking out blue and green colored tongues	1
A dog is standing on the side of a mountain	A dog is standing on a mountain	1
Two children are rolling in dirty water	Two children are rolling in muddy water	1
Two boys are laying in the ocean close to the beach	Two boys are laying in the ocean far to the beach	0
A brown and black dog is looking upwards	A brown and black dog is pointing the nose upwards	1
A large man is sitting in a military accessories shop	A large man is sitting in a military accessories store	1
A grey dog is bouncing a soccer ball on its head in a grass field	A grey dog is bouncing a soccer ball on its head on a lawn	1
A grey dog is bouncing a soccer ball on its head in a grass field	A grey dog is bouncing a tennis ball on its head in a grass field	0
A dog with a blue collar is playing with the ball in the garden	A dog with a blue collar is playing with the ball outside	1
A dog with a blue collar is not playing with the ball outside	A dog with a blue collar is playing with the ball outside	0
A young black child is standing on the edge of a body of water near some buckets	A young black child is waiting on the edge of a body of water near some buckets	1
A boy next to some buckets of rags is holding an object	A boy next to some buckets of rags is not holding an object	0
Two children are playing soccer in the park	Two children are not playing soccer in the park	0
A man is standing in the middle of a gym and is wearing a jersey	There is no man standing in the middle of a gym and is wearing a jersey	0
The snowboarder is jumping off the snow	A snowboarder is jumping off the snow	1
A snowboarder is jumping off the snow	There is no snowboarder jumping off the snow	0
The snowboarder is jumping off a snow covered hill	The snowboarder is jumping off a snowy hill	1
The snowboarder is not jumping off a snow covered hill	The snowboarder is jumping off a snow covered hill	0
There is no snowboarder jumping off the snow	The snowboarder is jumping off a snow covered hill	0
The snowboarder is jumping off a snow covered hill	A snowboarder is jumping off the snow	1
A lady is wearing a black dress and is carrying a white cross	A lady is dressed in black and is carrying a white cross	1
A woman in a black dress is pulling a cart and is standing in front of two men who are seated on a park bench	A woman in a black dress is pulling a cart and is standing near two men who are seated on a park bench	1
The boy is standing next to the opening of a fountain	A boy is standing next to the opening of a fountain	1
A distant person with a blue backpack is hiking in rocky area	A distant person with a blue backpack is hiking area full of rocks	1
A distant person with a blue backpack is hiking in rocky area	The person is walking	1
A distant person with a blue backpack is hiking in rocky area	The person is hiking	1
A ball is being chased by a yellow dog	A yellow dog is chasing a ball	1
A dog is turning on the grass and pursuing a flying tennis ball	A dog is turning on the grass and pursuing a flying ball	1
There is no dog turning on the grass and pursuing a flying ball	A dog is turning on the grass and pursuing a flying ball	0
A woman in blue jeans is standing in front of a group of children beside a house made of stone	A woman in blue jeans is standing in front of a group of children beside a stone built house	1
A lady is standing on the street and is surrounded by school children	No lady is standing on the street and is surrounded by school children	0
There is no guy leaping into the air in a wooded area	A guy is leaping into the air in a wooded area	0
A man with no shirt is jumping over a log	A shirtless man is jumping over a log	1
A dog is running with a volleyball	A dog is running with a ball	1
There is no dog running with a volleyball	A dog is running with a volleyball	0
A girl in a uniform is playing the flute with a band	A girl in a band is playing the flute	1
A girl in a uniform is playing the flute with a marching band	A girl in a band is playing an instrument	1
A man is standing at the wheel of a classic American car that has its door and trunk open	A person is standing at the wheel of a classic American car that has its door and trunk open	1
The man in blue is posing for a picture next to a vehicle	The man in blue is posing for a picture next to a car	1
Two people are sitting on a white bench	Two people are sitting on a bench	1
The woman is sitting near a flower bed and is overlooking a tunnel	A woman is sitting near a flower bed and is overlooking a tunnel	1
Two dogs and two people are walking in the woods	Two dogs and two people are walking in a wood	1
Two dogs and two people are sitting in the woods	Two dogs and two people are walking in the woods	0
A man is skiing down a hill and over a red obstacle	A man is skiing down a hill and jumping a red obstacle	1
Two men are taking a break from construction	Two men are taking a break from work	1
Two men are not taking a break from construction	Two men are taking a break from construction	0
Three friends are making faces for the camera	Three friends are making faces for a photo	1
Four people are walking along a city sidewalk and the one in the green hat is phoning someone	Four people are walking along a city sidewalk and the one in the green hat is talking on a cell phone	1
Four people are walking along a city sidewalk and the one in the green hat is talking on a cell phone	A group of people is walking down the street and a person in a green hat is on the phone	1
Three women are resting in a village	Three women are sitting in a village	1
A person with a red hooded jacket and a black backpack is walking near a rocky wall	A person with a red hooded jacket and a black backpack is not walking near a rocky wall	0
A man in a red jacket and khaki pants is walking through an American state	A person in a red jacket and khaki pants is walking through an American state	1
The players is maneuvering for the soccer ball	The players is maneuvering for the ball	1
A man in green is hitting a soccer ball and a man in purple and white is falling down	A man in green is kicking a soccer ball and a man in purple and white is falling down	1
Two children are playing in the surf	Two children are playing	1
Two children are not playing in the surf	Two children are playing in the surf	0
A man is wearing a purple shirt and black leather chaps and is posing for the camera	A model is wearing a purple shirt and black leather chaps and is posing for the camera	1
A man is wearing a purple shirt and black leather chaps and is posing for the camera	A man is not wearing a purple shirt and black leather chaps and is posing for the camera	0
The man dressed in chaps made of leather and a purple shirt is standing in front of some onlookers	The man dressed in leather chaps and a purple shirt is standing in front of someone lookers	1
Two dogs are running and trying to catch a soccer ball	Two dogs are running and trying to catch a ball	1
Men in costumes are walking around in the street	People in costumes are walking around in the street	1
No dog is in the sand that is blowing in the wind	A dog is in the sand that is blowing in the wind	0
A dog is in an area full of sand, with the sand that is being stirred up into the air and several plants are in the background	A dog is in the sand that is blowing in the wind	1
The black and white dog is running outdoors	A black and white dog is running outdoors	1
The black and white dog is running indoors	The black and white dog is running in a green yard	0
The black and white dog is running in a field	The black and white dog is running outdoors	1
The black and white dog is running in a green yard	The black and white dog is running outdoors	1
A couple standing on the curb	A man and a woman are standing on the curb	1
The dog is jumping in the shade of some trees	A dog is jumping in the shade of some trees	1
No dog is jumping in the shade of some trees	A dog is jumping in the shade of some trees	0
A person on a bike is not in the air near a body of water	A person on a bike is in the air near a body of water	0
A young boy is sitting in a bathing suit and waiting for the next race	A young swimmer is sitting in a bathing suit and waiting for the next race	1
A young swimmer is sitting in a bathing suit and waiting for the next race	A kid is waiting wearing swim gear	1
A young boy is sitting in a bathing suit and waiting for the next race	A kid is sitting wearing swim gear	1
Four dogs are playing in a grassy area	Four dogs are not playing in a grassy area	0
A cluster of four brown dogs are playing in a field of brown grass	Four dogs are playing in a area covered by grass	1
A cluster of four brown dogs are playing in a field of brown grass	Four dogs are playing in a grassy area	1
The dog is having a rest in the park	The dog is having a rest in the living room	0
A brown puppy is gnawing a wooden post that is stuck into the ground	A brown puppy is biting a pole	1
A woman is petting a dog near a stone trail	A woman is petting a dog near a stone path	1
A white car and a yellow car are racing down the track	Two cars are racing down the track	1
Two race cars are on a road in front of a grassy parking area	Two cars for racing are on a road in front of a grassy parking area	1
The orange rider is not driving a motorcycle on one wheel	The orange rider is driving a motorcycle on one wheel	0
A man on a yellow sport bike is doing a wheelie and a friend on a black bike is catching up	A biker on a yellow sport bike is doing a wheelie and a friend on a black bike is catching up	1
A group of children is playing tambourines	A group of children is not playing tambourines	0
A group of children in a church basement is playing maracas and tambourines	Tambourines are being played by a group of children	1
A group of children is not playing tambourines	A group of children in a church basement is playing maracas and tambourines	0
A group of children in a church basement is playing maracas and tambourines	A group of children is playing tambourines	1
A dog is running through the white snow	A dog is running through the snow	1
A dog is running through the snow	No dog is running through the snow	0
The brown dog is running in the snow	A dog is running through the snow	1
A black dog is running in the snow	A dog is running through the snow	1
A brown dog is running in the snow	A dog is running through the white snow	1
A brown dog is running in the snow	A dog is running through the snow	1
An elderly woman is sitting on a bench and is wearing a gray jacket and black pants	An old person is sitting on a bench	1
A small black and white dog is carrying a stick and is swimming	A small black and white dog is biting a stick and is swimming	1
A black and white dog is jumping for a ball	The black and white dog is jumping for the ball	1
There is no black and white dog jumping for a ball	A black and white dog is jumping for a ball	0
There is no dog standing on one leg and is waiting for a soccer ball	A dog is standing on one leg and is waiting for a soccer ball	0
People are riding two camels at the beach	People are riding two camels on the sand	1
No people are riding camels at the beach	People are riding two camels at the beach	0
A barefoot man in pajamas is looking toward the stars and is walking on the tennis court	A barefoot man in pajamas is looking toward the sky and is walking on the tennis court	1
The man is standing in a lake near a waterfall	The man is standing in a body of water near a waterfall	1
The man is standing in the water at the base of a waterfall	The man is standing in a body of water near a waterfall	1
A man is standing in the water at the base of a waterfall	The man is standing in a body of water near a waterfall	1
A brown and white dog is running through the river	A brown and white dog is not running through the river	0
A dog is emerging from a lake	An animal is emerging from a lake	1
No dog is emerging from a lake	A dog is emerging from a lake	0
A dog is running on the beach and chasing a ball	A dog is running on the sand and chasing a ball	1
A shirtless man is escorting a horse that is pulling a carriage along a paved road	A shirtless man is escorting a horse that is pulling a carriage along a road	1
A shirtless man is escorting a horse that is pulling a carriage along a dirty road	A shirtless man is leading a horse that is pulling a carriage	1
A shirtless man is escorting a horse that is pulling a carriage along a paved road	A shirtless man is leading a carriage that is being pulled by a horse	1
A shirtless man is escorting a horse that is pulling a carriage along a paved road	A shirtless man is leading a horse that is pulling a carriage	1
A woman in an orange shirt and clown makeup is standing in a park and others are looking on	A girl in an orange shirt and clown makeup is standing in a park and others are looking on	1
The girl is wearing an orange shirt and a striped tie	A girl is wearing an orange shirt and a striped tie	1
A bicyclist is performing a trick over a heavily graphitized wall	A bicyclist is performing a trick over wall full of graffiti	1
A woman is crouching down next to a dog and is smiling at a young girl sitting on the sidewalk	A woman is crouching down next to a dog and is smiling at a little girl sitting on the sidewalk	1
A black and white dog is carrying a big stick on the green grass	A black and white dog with a large branch is running in the field	1
A kid wearing a striped shirt is running barefoot on the sandy hill	A boy is running through the sand	1
The motorcycle racer is riding a red and black bike	No motorcycle racer is riding a red and black bike	0
The woman is wearing ear protection and is firing a gun at an indoor shooting range	A woman is shooting at target practice	1
A woman is wearing ear protection and is firing a gun at an indoor shooting range	A woman is firing at target practice	1
A little boy is sticking his tongue out for the camera and another boy is looking on	A little boy is sticking his tongue out for the camera and another boy is not looking	0
A little boy is sticking his tongue out for the camera and another boy is looking on	Two young boys are looking up at the camera and one is sticking out his tongue	1
A dog is running on concrete and is holding a blue ball	A dog is running on concrete and is holding a ball	1
